BB-T-X-B---B--M----?XT--B--X-B----B|--BB-|--X-|---MB--------?----|?T----T-XT-M-XB----B---B--M-T------|X|M----XB---B-|-T|T-MX--M-----?-B--B-------B?-M-B--T---|X-----?-TT-----X-|-?---------M-|||M-BMM---
|---BT-T--?--M-----M----T-?---B-|-----M|-B-M-X-BX-?XBT--B---|--BX--|-?--|M-X?--|----X--?--T-M--?T-T-B?|M-T?---?--?---BX--|--?--XXT-TB-B----X---?------X------?|T--TM-T--B?M-X--TXMX|--|---M----XTT----|?
T---?--T-------MMBT-----?-MM-BB-T----?B-T?-M-X-MB----T----MB--|-BT-?T-?X---T-X-MMTT-?---?-||T?-T-T--T-?---MTM----B|M-B-B-TX---||---|--------B--M--?---T------?XBX-T-?--M|-M-?B---?-B|-|?------T--T|MX--|
M-----------?T-T-----B---?---M?-?------?------?T?-|-?|B------?|--X--T---?-M--|----BBXB?------BT-X--?-----?--|-T----M----BM--X--|?BB-T-T---B?---T-BM|--MBT-M-----T-?-|------X---|?--BT|----|---M?-M--B--X
B--X--????--M||--?B-M-T---------M---X---X----------|?-------MXM----|--?-M---?MM-T--XM?--|-|-----B--M----XT|---XBM------B--M-B?-XX?B|--?B--BB-|-T?-|B----|-T--BMT--B--------X-TM-TB--?M--|?--?-----?-B--X
T-B|X-----X|--B---X-----X-BXM---|---X--?----B---B--TM-BX|-|--XM---B----M---XT-B?M?----|-BT---M-B-?---MB-XM--X-BXB?-B---B--T--B---?-----X----TB---|-MXB||---M?M?--B----X-?----B-|-|-T--|---|BX-M-B------X
T-B------|M---X-?-T|-|BB---T-X--------TXX-T|-M---------?-B----B-----T--BB|--M-?--X----M|X----?M--M|B--M?-MT?B---M--?----M-B-M-M-M--|-T?---B----T---XTX-XM?-X-----?---T-T---X?-----?-XMB--T--|M---T---X-X
TM-T----M-?XB|--|?B-M-----|B---BM--TTB?-?||XM|---M|?---M-X----?MM-MT--|?-XX|-T-------||T--T----?-?--BBB-B--|--B-|----?----M-X-T--M-X---B--T-----X??-B-X------M-B|--B-B|?-|?T-M--?-M|?-----|-T|M-XM--?B-v
-XT--?-?--?--B---?X---|B|-|---M----------?B---XX---TMTX---B--M||-?TB--------?X-M-X----B----?X-BBB--------X|--|B-M-B----?M------X--M---T-|-M---?-|B--X-X-B-M?---?-B--XX-?--?BX--?------?-X??-|--|-----T-f
-M---M---X-|--|B--------|----T|M-?---B--T--B------X-?B--?|-|TT-XMX|-?M--|--|------?-T?--TTB-XB--B-X----BXX?--B-X--B-B----M-BBM-|-?-??-M-B|----X------B---X|X-T-XXMX-M----T--BT-??-XM--X------X---------f
|T|B?XB--X?-?--|---T--T---?-B----M-X--?M--||-----X--T-T-B-M---T?--?-XX--------|----M-|B------M|T--X-X|--??---T----|MT?|--XM-------B---?--TX----?--X|?-B--MB-----T--|TM---T--?--?-B-T-----?--?-?-B?--?--f
------?----?-?BB|?---?-X|M--------?----M|-?-------?--------T-M--T-------TMB?-X---------?-------BB--X-XMM-|-------M--B------B--M-X----XXT---T?---|--M--B?-T---M?-|--BT----?XM----------M-BM?XBB?-|---?X-f
X--|-M---?|-----X---T-?-MB--X??-XT--?----M---B-M-X?-----?-|---?|--BTBB---|-B--M-----??-B|-------M---------B--X?X-----B?XTM|----?MMM---B-|-T--B-?T---B|---T----MMB--B---?MM--TM-MBB-|----X-T--B-TB--?--?f
-------------------------------------------------------------------------------------------------------------------------------------------------------------------------------------------------------f
m------------------------------------------------------------------------------------------------------------------------------------------------------------------------------------------------------X
XXXXXXXXXXXXXXXXXXXXXXXXXXXXXXXXXXXXXXXXXXXXXXXXXXXXXXXXXXXXXXXXXXXXXXXXXXXXXXXXXXXXXXXXXXXXXXXXXXXXXXXXXXXXXXXXXXXXXXXXXXXXXXXXXXXXXXXXXXXXXXXXXXXXXXXXXXXXXXXXXXXXXXXXXXXXXXXXXXXXXXXXXXXXXXXXXXXXXXXX
