---------------------------------------------------------------------------------------------------------------------------------------------------------------------------------------------------------
---------------------------------------------------------------------------------------------------------------------------------------------------------------------------------------------------------
---------------------------------------------------------------------------------------------------------------------------------------------------------------------------------------------------------
---------------------------------------------------------------------------------------------------------------------------------------------------------------------------------------------------------
---------------------------------------------------------------------------------------------------------------------------------------------------------------------------------------------------------
---------------------------------------------------------------------------------------------------------------------------------------------------------------------------------------------------------
----------------------------------------------------------------------------------E----------------------------------------------------------------------------------------------------------------------
----------------------?---------------------------------------------------------BBBBBBBB---BBB?--------------?-----------BBB----B??B--------------------------------------------------------XX----------v
-------------------------------------------------------------------------------------------------------------------------------------------------------------------------------------------XXX----------f
-------------------------------------------------------------------------------E----------------------------------------------------------------------------------------------------------XXXX----------f
----------------------------------------------------------------B------------------------------------------------------------------------------------------------------------------------XXXXX----------f
----------------?---B?BMB---------------------T----------T-------------------BMB--------------B-----BB----?--?--?-----B----------BB------X--X----------XX--X------------BB?B------------XXXXXX----------f
--------------------------------------T-------|----------|------------------------------------------------------------------------------XX--XX--------XXX--XX--------------------------XXXXXXX----------f
----------------------------T---------|-------|----------|-----------------------------------------------------------------------------XXX--XXX------XXXX--XXX-----T---------------T--XXXXXXXX----------f
m--------------------E------|---------|--E----|------E-E-|-------------------------------------E-E--------E-----------------EE-E-E----XXXX--XXXX----XXXXX--XXXX----|----------EE---|-XXXXXXXXX----------X
XXXXXXXXXXXXXXXXXXXXXXXXXXXXXXXXXXXXXXXXXXXXXXXXXXXXXXXXXXXXXXXXXXXXX--XXXXXXXXXXXXXXX---XXXXXXXXXXXXXXXXXXXXXXXXXXXXXXXXXXXXXXXXXXXXXXXXXXXXXXXXXXXXXXXX--XXXXXXXXXXXXXXXXXXXXXXXXXXXXXXXXXXXXXXXXXXXXXX
