X--M--?----TBX---B-oT-B-?T---T---|M--o-XE---|?--X?T-o---E--M?oM-oM---BE-|E-----M---T--o||?-M|------?-|---MX-MT-o|-E?--XX---MX-o-M------EM---------E-X---||--|?T--B|X-|----|BX---o-|o---MMXM?oM---X--|-?X
M-MEBB--E-?-|-?-BE?X---E|oM-------------|-o-XM-MM--MB?--T?---M---E--?--ME-EB-M-?--M-?M--E-TX-Eo--T---|-------M-?-oEE--BB-EX--T--EoT|---?M-XoT?TB-?o--BX-E-E-|?X-XT---E--X-E--EXMB?X--?BB-|---|E---MM--|B
Eo-EXB----X-MB----X--???-Moo------?-?EoM-E?--TMBXoT-X-?oM--?|oBM----?-ME---M-|o??----o---??X--M--ET--?-?-M---|XoEM-?----B|---|E--M-----------o-B-X--EXEXo-?-X--MBT-E-E-T-M------------T?-E--oTB---E--X-?
?--|--o-B--T?-BT|-|T-?B-----X-X---T-M|--B--M-EoXTE-|-MM-|M-??M?-MBM----XB--T----oB?o---BB|-------|-M|XB-----o-o--E------X--E--X-T----B---E-XM-o?-X---|B--XXT-T-To-M|--??o|--E?M-MMB--|B---?----?-M|--oBT
?-B-XXM--T---E-B--------|-?B|---X--To-?-?--X--Mo|-X|T----o--o--XBoTT--?M---oX-X-X--X|-XM?E?B-o------M-ME-BB--E-ET-M-X|---------TM|-T---B|TToX-E-X-XX-o--XMT---oM-?-EB--Bo-E----oEE--|E--BM-ToM-E-EX-M-Bo
o|-|----MM?-TE---?-o--o-----|-o-------E-----?-EBX-BEXX---X-X--o?---XB---X----M|EoB-?B---T----XXoo-E?-M---oE-E-|---MBB-oToE-oT--MTE-B--T--MoT--|X-?---B-------M-TEXM-|-------oo---M--X-T---|-M--oM-T---To
T----T--o----TT-E-|-|BoXE-M---?BM-?X--B---?--|o--M-----?-----M?EB|--|M-Bo--B-??--X-TT-XB?-o||?B--ETMT--------EM--o|--MBXB-M-|-----EX-?----|TT|-B?---B-X|---|-oTEXT--|-X----o-M---|MT--|-B-MT?Xo--X--TX|B
----|M--B--BXMB---T---?o-B--T-o|-|--?Eo-B---ooo--??--E-Bo-oM?E--oBT-BX---B|---?--T|---------|X--ET-----M-|------------|Bo?-E|---?---o----EM---o--|--E?M?E-EE--o--B-|--E-o-??----?-M-E-B--B?-----?|-B-T|v
BMM-MT---T-o--MBX---------B-M?o-EXE--o--------E---T-?X|-|Eo-XB--TX-|||B-|?-----Eo----M-o-o---MB----B----|---?XE--?--E----T--XX-X--To--X-EEo--?-o|--X-|ETX---T-E-T|-BM?-X---T-----|M|---?---TE-B-o-X-?--T
-----XX-o--B?--|-E------|----M---E---M-|--EB--|-?E---o|--|----B---B|---T-B----?oE---?|-o----BBM-?-B--?---?X-M-X|o--XMB?-o|E-|--E----MMBB-T----X|-M-M--oT---EX----?B?-?---X---B-B-B----|-X--o-T||-E--X-T|
|-B-T--|--o-?o---?|-----XE?-|-|?--E---||?-----M--o---?---------BT-T-|oT-X--TB-o-E----X-------B?T---T-M?T---|E-MT--|?-?-T-E|o-MB-E-?------TE-ToXM-Bo--E-M---X-?-MB--|---M-------o--o-|-o--ET-XT|E-T----MT
?----BB---o---EE-|-----oM------TB?|?-T-T-----BB-MMX----ooMX|-?-?----M-X----?B?|B--E--B--MoX-----M----M----MoME||-M-ETT-B-----o--T-B--E-X-B|MT---M-M-X|B-T--B----|---To--XT-|o---X?------E|B-X-B--MXTEEXo
TTTo--BoT?|---X-|M|--E|-M--?-E??--X---?o--?--B-X|-B|--B-|MX----X-E?-|?--ME-------XT|T--|T|----?|M-E?---?---B-T-?----E--oBB-X-X-X--X-T-o----oE---oXM-X-X-M|?-T--M-M-T-B--M?-TE?MXM-----o-|-T--X-B-----X-B
|?E---M------X-oBo--?-?--?-?|B---?M?-T--T-----E---E------?-o--|-|oEE--B-----X-XE----EX-T--o|X?E----EM--|M---X-B--X--o--|----X--|M--T-TT---X---XXEMX---M-||-------oEBTo|E|----XXTT-T-o---EMT?E-o--TE-X--?
m----E-BTo----?-Bo-E-?---X-B--E--?BE---B--TT|M-E-E---?--XB----E-X?Xo--T?T--TX?--o-?-?-E?--ME-----o-o-M------E-T-EM--XXo--XT-----B---?--o|--T--o-T-----To-B----o-X-------T------X-ooBTBM?--X?--------E---
XXXXXXXXXXXXXXXXXXXXXXXXXXXXXXXXXXXXXXXXXXXXXXXXXXXXXXXXXXXXXXXXXXXXXXXXXXXXXXXXXXXXXXXXXXXXXXXXXXXXXXXXXXXXXXXXXXXXXXXXXXXXXXXXXXXXXXXXXXXXXXXXXXXXXXXXXXXXXXXXXXXXXXXXXXXXXXXXXXXXXXXXXXXXXXXXXXXXXXXX
