-B|------MB-|-M--BEXBB--ET--E?--Xo---?T?X-B----o|----T--T|XM-E--B|?-|-EB|T--|T-o-----B?oM-M-------||E------TMME-----MT----E---X-E---TEX-?--M-?--------?T|-TT---Bo-----|-|-?B---|TTXo?--E-EE--E-T-MX-X?-B
?--BBM-||--B---?-----E--MTT---ET----T---M---B?----M-?---|-B------X|----B-|--B--?XM-|TX-T--T--TB----ME-TX--B----BX----|Bo-|--X|E------B-o-B|Eo-TE?-X-----TX---|---TEM---B?M?-T?o---E|--|B-----BM|-|M?--BB
|-------?-ME?-?---T-EM--M--BXMM-Eo--?---?E-----B-M---XM---------?M--B|-M?|-B-EXT--M-MX-E-E|?---X----XMX-X--?X-B-----------------MXEXM?-M-?-?---T?--ME|T--To-?--|B--|MEXo--M-X|--T|-E|E-??--M-|--B-T|EB-T
BB--?--o-T-M---X-----oT-T-?|?-X---T-?MEoE-X--|-?--|--E-|oX-------|?-B----T---MB-?EE--?|o-|TT-----MT-|-|EB|--o-?X---MEo-?-B??-|-|----M---T|--TE-|-MT---B-E--o|--|-?-X---------B?ETTX---M|T-o?--B-MX---o--
M--BXo-X--X-?-E|--------|--oB---X---T--T---?-XB---T-MEE---|--|o?EoX-EX---X--o---MBX----MX------|---o?--oXX-EB-|BT---T-T-M--BM-?------XX|M------BBE--Bo-M----|?E--oXo?-E-----E----B?|--BX--XoX----EX-T-MM
B-|X||---T-o-o--||-?--||------?TMM-X---X----T---T--E-|-TE-------E-|o----M|-T-o-TEX-----EB--TT---T----?-----ME--?o-----EM--TB--|---?-X-BT--BT-?---M-|-|?-|X--?-EB-BoM-X-T-X--?XMXBEX?-XoBTBT-|EXM---M||-B
?-TMT?------ToTE------o-M-BoB-BB-ooM-XB-?--TEoo-?--MT--T--M-M?-oET?o|-|-XE-?---oM--?E---T-------E-TE---??|-|--EEo--X?-MoM-T-EMMX-TMoT-----T--T-E-----|o-----o-B-MX|-------|--T--oXX-|-XTMoE-?-------|-XB
TX--?------XB----|oB?|--?-o-T-M-oT|M--M----------E-X??---X--X---|X?--|--E-Mo-M|--|BE?-----E?T----oTT-EM|----?-MT-E-|------T-METEM|--XoMMT-XT-------oM---EMX------oE--T-----E---|------B--MMXoX---|-?--Ev
oXXEX?B-----B---X-|-X-o--|X--B-E-M-?-E-E?-XoB----o--M?EM-T-B-TB-o|--M||X-?-BM-|?T-?T-EX--M|TTB-TT--M----|-T-T-B-E?--B--|?-|oB---oo-ET-TM---o--E----o|T--XM-X-o--X---T|M|T----|?M-----o---MT-M-----M--|-o
EoM-M|T--ToM-M?M---T-XoME--?B|-o---B?-oB-B|-o--M|-E-o-EMX?----o----X|--o-TM---M------XE----BTB|--E-?T-|-T--X---B-?B--o-BB-Bo---ET?T-M?--EB----TX--X-M---oXo-X--T---T--X-|-|-X-T-----B|B----?-XMM--TTT--B
B|o|T--XB-|MB-----?-|?----BoT----To|-T--T?E|--o-oE---TB-E|--TXTXTXBT|?--|-BTET------T-E----o?----|-E|--------|-?-------o?X--Eo-o-----X-MT-o-X----T||ooB---|?-----------EE-B-?T---M?|---oMoEXBo?--B-M--?X
|-------?-E----?TTT-M-T-?E-----E|-M-EBB--E-Bo----BM|B|X-----o---T?|||MT--EX----?M-?-|------B?-M-|TTM??-X-M||-T?-?X-------B-B-oM-M-?--EX--o-?-T-|XT-|-B-||MB--TB-Eo--To----ET-?M-E-E-----o-?-BM-o-M--?--T
TE-T-E-XT?--------|----T-?---B---MB?-|---E-oB-|--Eo--B---?-----oTBEB----TT|E--EX----ooBT---T||o?-XBTXE-?M?-|---B-----B--Mo---XB---|-T-?-E-o-|E-B--T-T--o-|-X--MT|-oo-E----MTo-T----E-X-B-X----E-T-----TX
?X-E----ooMB--MM|----?--?-o--?-M-ToT---?--oM?E-BX-B---o?|BE?--E-X-XBB--------oBBB-|?-X--TTT--X??-?-oB----M---||---B----E--X-----||T-----T-T-M-------ETB-BB--E----?ETM-o-oB?------|-||B-|-----?---X-E--?T
m|XT--?-X-TB----|---X--X---E-M-Xo--T|TX---|-B-T?E-TBT-E--o-----|XE-BT|X--?M-B--T-T?------M---?-X-?TE-B-EM--------o-EMXT---------EB--?--|?|---TTM-E-T?-M------TB----o?-?--T?T?T-T-TE?-T---T--|-ME-o-ET|TE
XXXXXXXXXXXXXXXXXXXXXXXXXXXXXXXXXXXXXXXXXXXXXXXXXXXXXXXXXXXXXXXXXXXXXXXXXXXXXXXXXXXXXXXXXXXXXXXXXXXXXXXXXXXXXXXXXXXXXXXXXXXXXXXXXXXXXXXXXXXXXXXXXXXXXXXXXXXXXXXXXXXXXXXXXXXXXXXXXXXXXXXXXXXXXXXXXXXXXXXX
