XBM-|-|-B|---?-E?-|------T-M-o--E---B----TE-E|--o-EX-?B---?Xo-----E----B----T------o-----M---??M|-B-----oMT----T-?TB---TT--E???-?--oXBB-------?BoEEMX---T----ME--X-o-B----oE|XB-Xoo-----B--|---M?ME-B-TM
XT-T-----XXEB---X-EX|-oT--X-M--T-X--?--o--T-|M||------X-E-MXM---B-BT?-M?o-EM--?o|-------X----X-|TT--B-----------EX---?-T--o-----B?To-ooM|-T----MEoB----|?-E-E--?--B---|-XB---X|B-----|--Bo-?---B--ETBEE|
|-----MX?BM---oB----?E---M----B--E-Bo----T--MB||B--M||---o-o?o??BXB----B---Xo-?E--TXoT----?-X--|--|-|-ooBB----B|-E-MT-o---|-MX--MT-?-|----|-|M|-X-X--M--E|--XT--T-?BoE----M?----??o-|T-?o--|o----oT---B-
EX-|M--B---TM?EXX--?---MT-T---TM--?-XX-----B--o-XTXo-o---E---?B-B---?X?M----|X|----?-B-|M-T-M-M-XT--E-oX-o|-XE-TB-E-?|-T|--?ME|o-?-|---o------X-o|-EBo--EEM--T-EB--E---T-E--T--BE---|XT-----|-X-?--MEEEM
---B-TT------|------BB---B-?X?------E-To-M-X--M-X---o-M--oX--X---|?X-o---B--?-----XB-?--B?-T-?|--M-------E------TE|Xo--oMT-B-?o--X-|BMX-B-XM?-|-?-T--TTM?EoM------B-------T-T?-oM-E--||M---B----o----T?M
|E---X--M----|-T---|--B-|-M|---?B-B-o---BXoEEX-?--oX-E-|?M--MEB-o-ToBM--M-X-?-----o---EM---|--E--?----X-o--B|X-E??-----XooM?o-?--?E-ET|--o-XXX----To-----E--------T???X-B---M----o----oME-TXBEEMo-T--TM?
X|T-|T----B-----X-BT|-|o--MBXXTXB-----Mo--?--B---oB-X--|--X----?EBTM-B--M-X---|-Eo-|-E--|-|------|-E--TB|EXTT--|---XoT-o?---Mo--|----o------BM-?-B-?--T-?---TXT-|M-T-|----EEE------|Xo-B---|--X-T-----EE
TTXT---X---BEoE-To-o|-M-X------||-o--o--?--|--|-?-o-oE-oX--------E---?-o-XB?T-TM----|-?-B-o--T------o---oET----|-B?----ME-B|--|?o-----B-M-M--oMT|E-|B-M-T-o|--B--oM----BB?|X-M--ME--?-MT--|--oXM-|----ov
XX------|--|-------BTM--X--?-M-T--T-T--|MB-|--M----------BMX---BX?----T-------?-||M------M----o--T-X--?--E-----XX--oB--|-E-T----M-|?-||--?BEBM-ET-|--?----BMX?B-M--?-------E---BTTXT--B--?--MEXMoE--XBBE
MXTX-X?-B--o-T|BE--o-|Bo--T?E-M--Mo--Xo-o--oEE---ET----X-X------|-|---?BE-|--o---T-M-X----MX--M-----?----M-----BoX--T-T---XMBT-B---?----?-E-o--?-----Xo-M------B-T-----TM-|-TM-------BB-|?B--T--------|?
TX--TM--E---o|--EB-T-B---M----|X-TX-X-?--T-M?o-----M--Bo------E-To?-XB---oXX--M-?-o---X-?-ooX-o-?-B-X----|--T--|--B-T-T-?-|M--o---TBM|-?-BB-oX----|-|--T-E-------Eo-oBE|M--|M--Xoo-M-XoX--?--|-BE-----ET
?B-o-?EX-?---M---BB---To------?-TTT------?--T--E--XEM-T|--MB?X-MXX--E-oM----B|M-X|--?B-TX--oM---B--B--T--BM-o-B|-----EXMo--EoX--?M-X-|--oXBo-BBB-MME?-ooXE--XM-|-X-T----BX--|E----E-o-|---X--X------MEoM
BX?-T--|E-?----M|-oB-M-|EToX---T-?--BX-M-----X-oB---------o---?oM--Xo-?---BT?---BE----XXM|--oX-Xo-XX-BXB-X-M------Eo-----|--o-T---?-M-E|-o--E---o?--E-----E-MT--------B----T--X---EXXE--T-------M----?MX
-T----B---E-BEB-B-B-T---X--o---o----X-?|-----?ME?-|oB-BB-?--B-|--E|X|----T-X--o--MMB-T?----o-BE---o---o--?X-E-|--B-|B-o-|-oMXB-----?---?--?X--o-?oB-B-----X--B-----BBE|-o--B---E--|--?BXT-B-----B--E-XT|
m?EB-M-----MTE-B-X-?-BM-T--o-E-T--Xo-M-|------E--|----TM|M-o--BoE-EMX--M-?E-X---X-T--B-o-BE--BE----B------MX-?M-BM-X-X-E---|-o|E----ETM-B-X--ME-|---M-EB---??---B-?T-?X-|T-----MoM----Bo--M?XB--T|-----X
XXXXXXXXXXXXXXXXXXXXXXXXXXXXXXXXXXXXXXXXXXXXXXXXXXXXXXXXXXXXXXXXXXXXXXXXXXXXXXXXXXXXXXXXXXXXXXXXXXXXXXXXXXXXXXXXXXXXXXXXXXXXXXXXXXXXXXXXXXXXXXXXXXXXXXXXXXXXXXXXXXXXXXXXXXXXXXXXXXXXXXXXXXXXXXXXXXXXXXXX
