E----BM-o--------|?--X-BBXoX-E|-E--|X-M----BT?T-X--X?--T-|?---TXX-BXXT-T|-BMEMTB---|ToM----?-MTX--X----??-----?----??-?|TMTTT-E-X-T-M-------o-EE--o---E----M---|-|-MMB-|||BX---EE-----EETT-E----Eo-----T
B--M-?-|--X--?----------|---B|M---X---??-oX----?TXBMT-----|-o-----oEEE-EE-o-TE--BMT|--X-|M-B-----TTM-XE---|-?-T-M--B---M?|B-MB-|---|MTB--?-oT|---------TMB-XB---?-B---BE-TB------TT--TB-E-M--T?B------Xo
B-X---M?--BM--MB-BBXETETB-X----X-?B----|-T-?-To--M-B-oToX--T--oE---B--|----XBB--?X-MB?X-?----|--BEX-M-B-X-|X-----B?B--||-E-MET--T-o---EBTM---?---EBXT-----M-B-|B-|-M-o|-oX--B-X|Eo---E-B?B------X?-B-?-?
X----M-X-BMM---T-?---X|?--BM-?--?oX-B?-?--------oM-E-|-EB-M-EB--ToTX--X----|-??-EMM---B-X|--T-X----M-|--o||?E?|M--BX-?oB-B---X|---T?o-oX--B-EE?-----EMM--|--M---T--MB-BE-?-XB|---B-X-T--X-XMMB--EB-----|
M-M-B--E---M--EMTB-----XM--|-X-M-BMB----X--B-----TT-?-X--EE-----|BE?-B---T?---BMX|-?ToE---BX-?-oXT|-BE---M---E-XT-X---o-B--M-?|E-oBT----XT-----BEX---M----BB-oX|----|-B-T--|---|?M|--|-B-Eo-X?X----M-T-E
E---?---E-?E--MB?---B--M|E----?--X-o-EX-----BTo-X|---B|T--E-B-?------TMB--BT-XTBM--?o--BoB--B-?M----?-|-||T--|?--oB--M-B------o-B-X-?B--E?--XoB?B--X--B--B-X?T?B-----|-X-XE|--?X-BT|-oB--|--T-|--T-----o
???-B-B--B----B----BT-?----M-E----TM-M-B---XT--|T?-----T---XT-B-----Mo-X-X?||--?X-B-E--o----?-|?--|--B|--M-TXo--M--T-?-|---T-BTXE--|??---Eo--BB--M---?E----o-Bo---T---|BE---?-MT-T|B?MB----B---|B?BEX--B
T-?-o-EE-|-?--MMXM?-MT--------B|oXB-------TT-|--M--------EMB-XT|--X-M--?-B-|-||XE-B--B--M|---X---T-------M--?-oB-?----BB-TBX-BXo-M-----M----BEB|?-MM---o|-E-----o----------M-TX|---E|E---|EM|oX--TXo---v
X--B--XE-XBMX--|B?TM--?E-oB--EXE|X-MMB--BX--?-?-?--B|?--M-XE-MB--BB---E----?---??X---T--?-------X-o------M-B--T--|-XE-|-?-M--M-T?---X---E|-T??B--?o-|-|EB-X--BE--T--X----E-?----B-M--o-TB?|o-MBE-?---E-?
X-B-X-X?---M----?-B--EMXT?----MB-----BT-B----E--?---BB?----|XM---T------X--B-B----|--E?TX-T--X--M-M-M--|-T---T?-|--X?--?-BEB----oX----T?TBT-?---??oT-XT---?------M-|----?--Bo?-X--------?--------X---?-M
T-|-TX-BT?EM-XM-|--B-B--?-EXBo--BX-?|--o--XE-oT--B-M--BX----To-T-XE-|X-X---T--X-B?--|T--X----B-XBT-|-B--T--E---B--BXTB-------T-TTX-|BB-??T----|------B-?T--B-?----M-MMMM-MT-?----?-E---B-MM-TET-T--?---X
oB-|-?-o-B---E----B|--|?-XEM?B---------TEM-B----EB---o-----E|E|--B-ooE-M-B-M---XM-X-B-M--B-T-X--B-o?TM-B-T--BXM-EX----MME-M-----|EM|--M-?-E-----?X--T-|EM?|-?--T-E-E----T|-E|X|o--B---M---XB----E-B----B
T-MTET--T------EXEEMXBBE------MT-MT-----??X--T---|T-EM---?o?-ooT-EM--BB---------M?--XT-T|-M-E?---------B?--|E---|BB-E-oB-X-----|--?-BB---BB--?-?----??|-X--BB---BMTT||B---ET||-B|Bo--X----?B--E---?----M
B---XM-|--oX---BBMT--BBX---o-B--X-|T-T---?-B??--BB-M-T----T---M|T-B---BE-oX-----X----M-----|--MX-T|o----?E|?oX--EM?-?-----X---T--X?EEB----M-M--|E|XM-B--EB??-M-BMEB-EX--B-X-------o?--M---|--E-|-|?T--X-
mT-Xo--o--M-M--MB-?----?-E-EX?-E?--TX-E-----oBEB-B--E--?|-o?EE?oBM-B--BTE---|o--B|---------TB-|o-E-----EE--B--Xo--X|TX----B?----?T?--BoB---?-----o------EB--?-B-||---oB--o--MM---T-E--E---Eo-oXE-|-E--M-
X-----oo--o-oooo-o--o---oooo--o--o--oooooooo-o-o---o-ooo--o-o--ooo--o--oo-o--o-o-o--o--ooo-o--oo-o--o--o-o-o-ooooo--ooo----o-oooooo--o------o--o--oo--o-oo-oo-oo-oo---oooo-o--oo-ooo----oo-oo---o-oo--oX
