B-BT--B--EM--?B--To?--M---|---TME-?X-BM----o--T--T??--B--?----?-o--X-oTB---TT|--Xo-Mo-|T-E?-B-|--X|-?T?---M?--TTB---?-o---ME--?-M---?-oEBM--X-----B-B-B--o--Mo--M--X--EB------MX-?-E-B---X-M-T--o|E---|?
-T--B-----Bo---M-|----?--M---|B-ET-------Bo-----o-M--X--X|-EoB--|T|??XMMT-?-M-E|E|X--o----?----E---T----?---ME-oT------o--?--o-E------T---oM-?--B----BM-M-|Xoo-|----?o-B?---|-------|?|E?X-Eoo------||oB
M?X---XM----?--o--M|-?--M-|-M-oMM---EM-T-T--?-X??o|-?-?B-|--?-X?--BX?X--BToT-?Eo--E--Moo-|B-----Xo?|--?-?-T||ToE-|M--oX-?|B-XXo--TB-----E---BE----MX-oEXoB--X|M-----M--M-|-X---ME-ME-B?B--M|-BBT-|-----T
EM-?----B--MT|-----o-BXM-BX-o--?B-M-E|?E---|o--|E--?M-o-o--EBM-MMEX-XXX---E---B-?|--T-oMBo|o-MB----XXX--|--------MM--|?-XT-E-To---T---TX--TX--?-?|-T?-----XE-E-M---XM?-o--|EBoE-TXXT--EE---|-E-oE----||-
oM--|-?-|-----o------E---T--TT|---Mo---BBTXT---X-|--E-ETE|----|MBT?M---------M-------M?oE---|-E--E--?X-EEoXE-|-------------To--XX-?-T?TEEo----E-Eo-X--?---X---?B----?-M---|-XB-X-Bo---MBXT-XT--T---T?-Eo
B-----EX|-oB--?-----E-TEo----oX-EB---?-|-EX--|--T-E---TB?X--?-T|--?--X-TM-T------XE?E--?X--o-||-oM------o-EB---M-o-X--|T-M?------E-XM-------M---?o-ET-M--X-B|B-----o------TTXT-EE------XBX------E?-B--?B
--|-B-?--M--|-|TB-T-||-Mo-|-??-T-----B---XM---ET-X----ME-EBX--?-TE-o------BT---?-o-M-MTX-TB------TXo---X---B-|--o--MMM-E---?--EX-----To-E---|X?-T-|---X-?ET-BBo-M-X|-B-oMB-X-?-X-X---XE-X|-T??o?--TTXX-B
--Mo----?BT---------X--E-oX-oo-XME-----|-T|?E--XEX|---|E---EX---|B--M-o?--|Xo-To--B-|-M-|?--o?-ET-E--TT-----|--|o--o|-XM---|E--o---E--|--T-?X---|-B-|--|o--ET---M---Xo--------?oo--M-M---E-T---X--T----v
M?-|-B-M---|?-TM----T--ET---o-X---T-XB-X--|----TE----o-----B--X--o-|T|o---XB-o---X---EBo-||?X|?ET-B--B--M-E-MEX---||o|T?-T---M---M---|T-M-o---o--To----?X-E---X?-o|--T--|---|X|o---M--?M---X---T-XMM-X-o
T---XT------B-MX|-T--M??-----T-|-o-B?-----?|-T--BBBTo-M|B------B----?----o-oT--B--ET?-BT---?M--oE-Mo-----?-E|--To---BT-E----|----M-------T-TTB---B?----|--E---E-?-T-----||T------T---X?--oE---|-?B--ME--
|--?--|--M-M--T-E--X--M?--M---E---oo----------|-MB--T?----X-E-T-X--o--??XXoX---E----|M-o--Bo-|EM?--|-|E-X?o--o---o?--X--T-----XB-X----XTX-M-X-ETT---M---BXBB--M|-?oT-o--XT-B--?o--E--T---|-o-?o----M--BT
|B----?oXEXTMX--B-M-X?o|-?----o-BTM---XMoT-----M?-B-?--|To-?---|XM|XB-T-X-Mo--?---T--o--XMT?M|-XTM?o---Bo----B-E-?--|-T-Mo--?T--B-o-o----X--XE---?M--TXX|?B?o?B---EMT--E---E-o-----?-M--o------o|-X----o
|o-o---------TTE--TMoE-?-?--o-MT-T-o|E?-EBo|-M-T---M|-B--B-|-X-B--o---B---?T-BXMT----|--T--TX----T----o--?E---|-E----T--M-?-|-E--MTM------|-X--|X-X---oT-TT--T-BE---B-||?X--T---o-----E-EX----?-?-o-X|-|
|-?B---o-----o-X--|-?ETXT-EXT--X--B----B--Xo-X-X|---T-B-T||X-o----o--B---B----oBoE--?T--BMT--MT---X----M--XX--o--B-E-M--M-MBTE?---XoEX?|-o----TME-X-ME-B-BBo------?ME-----T-?-B--|-oX-?-|-BE|------B-M-?
m---M?-----B|----?------E---|o-o--o--------?T--o|-E-oTEXEBMM-|---------X-B-EM-?-BT---ETTE-?--TM----?-X-Mo-----MEE?|-----T---X----?M-------E-E-o-X----ET-M------B??--M-E|-|o?--M--EToTB--E?---BM--?X-?-o|
XXXXXXXXXXXXXXXXXXXXXXXXXXXXXXXXXXXXXXXXXXXXXXXXXXXXXXXXXXXXXXXXXXXXXXXXXXXXXXXXXXXXXXXXXXXXXXXXXXXXXXXXXXXXXXXXXXXXXXXXXXXXXXXXXXXXXXXXXXXXXXXXXXXXXXXXXXXXXXXXXXXXXXXXXXXXXXXXXXXXXXXXXXXXXXXXXXXXXXXX
