o---X--B--EToTMT|-----ME|-o-o?-|-o?-BME?|o---|-BT-XM-BM-?M-MX-----|------E-E|---E-XB|?-X----E-|-??--TB-ME--XB--TE-XM---|-ME?-----X|oTX---XTo-M--|oM---o--?--?----o--o|B-X---T-o-T-?--B?----B?BM--------B
B-|--o-------T?-M---M-B---B?|---B-?-X---B-TM?---E--------|---T-E---M-B-B-E|-E---TB-T-----?|o-M-E?MX-oME-Bo|-Bo----T----M-----T-T--ME---M-|------B-M--T--T---X-E-M--?-----?BBT--XBT--|B??--?-X------B-|-?
XE-B-E-BT?------E-M---?BX----B-?--B|-TT------MBM-X---?-EE-B---BEBMB--?--?T-X-oBTX-B---?-TX--E|B?-B--|MB---E---?--?----?TM---M--M-------|-o---B-o?-B-EE---M?oX-o--?-?MEM----B---T--E|??-M|--BM---?XM---BE
E-T--|M-BoB--|M-----?BTT-?B---?------T|----B|?---B--BEEMB-||----?--E?-?---T--T-M-|---------M--B---B-?-X----------T?-BBX--M?--|--E-MM-M---E-----E------------T|---M---?---|--E?-TEEBEE-----MBMBEE-B-B-T|-
----EB------BM-M--E-?----MooBEMTBX------?--|--?oT------??B----?|----T-?B?-----E-M?-MEBE--------BBX---------E|-T-T--B|-B-B----|T---T-?-TTETE---?---TMX-?--oX--X----oXBo----||--B-T-?o-MEB?o---BB|EM-T---|
EM----T----M--------E-??B---E--|E------o--TE-EET-?-M-BB-M----M--?B---?B-?B-TX---M?MoB-MM-To--X----TT?--X?--?-MT----B--E--?---------B-E--T-|B-T---M|--B-?MB---E-B-?-----BoE|B---M|--|--T-E--?-M--B----B-?
o--M-M-T---?--?-BT-B--?B-X-T-TT-ME-BE|-XXT-?-MM--?|----TEB-M--EoMoo------BoM-----|---T-E-X---?B-|-MBT-E---MBBoMM--?--BBB-----TBT-?----B-B--BT----|-B---E?E----B-------B--?-E-XB-?-TE--MEEB---|-?X-B--M-?
TM-E|------oM-----B---B--BM----o-MoE---XB-BMM-----M?TB--M-MT----EM----X-----B?---E?-o---B--|-B--MEB-M---M--E---B---TMX---|-E?-----E-?|T--|-M--BB-T-----B---T-M--B----B|-Bo-ME---BT-B?|-TBT?-B-BBE?E-B|-v
E|MBE-----BM---|-TE---X----XT--B-----T-M||---|E-?---X-------|---?|---??--BTX-T--M-|-|-------E-|B|B-|-?-oE--||-----T----B---X-|BB?TB--X-|-B?--|--E--B?-E--|X-?-TX-M----XM-T--B?TMX---?-E--T||M--B-??BM--M
X--EB-X-XT----BX-o|---M?-MBE|--E-TMM--E--EM--EB?TB----T-EE-X-TB---ET|EX---EE?T---M--|--?-XMMB?--X----X--T---?T-?---?-B-E-------M-o|XT?o-----o---M?X--o-B|-M---o----|-|-------EX------T-----|-o--EBT---BB
M--?--MB-------?B-B----B---T-o-B--XTT-------?--M-?T-E-B-MB??--oo--E-B|-----T-E--X-TT-------?---|----B--------?E-MM-?------E-ETTX--MB-B?XT--||-E-|MTB--o---E--E|X-|---|-E------|---BT-?---E-|-M-?B---B--?
|---B-o-EB--------E-BT---T--?---B--E-?MTX-XM-T---TE?T--M---B-E-E|EM---E--|---B-XM-----E---E-EBE----T-|TB--o-BEX------B?-o|-X-?|XM---M----X||--?--T-----B??EB-B--M-B-|B--B-o-T-?----X-oB--?T----T--E-----
E--M------M--M---B-E-o-T-M-----M----M---E-|--E?--B-o?-|--B-ME--?-B-o-----M-M-XE-|-TM-o-M-----T-----?|-------EBM?M?----B-E--?B--B--TB-------?-E-?-T--TB-B---B---|-----B---?TB-X------TT---E--M--o|----oET
-T----MT?-o---o---?M--|-B-?BM--oB---?T-------B----------X---?BT?B-T-E-MTo?-X-o---B---BE--?B?------BBo-E-M-T-X---|-T-E|--?--B-??Mo-|M---|-----M---EX--?M-B--?||E---E-ME?oT-----X-B-B-?-E?---?----|?-----X
m-B--MEoBBM-|-oB---T---oMTTB-?--ET-XM--o-E-|MM-M---oBM-B-----E--MB---B--?---X-|T-B?B---?--B-M----|---B---?B-B-----T-BM-MM|----EM-|X--------M-T-Bo--|-XXX--oMo|-M-ET----|--?--T--o--Mo|--TE--X---B------|
X-XX-X-X--XX-X-X--XX--XXXX--X---XXXXX-XX-X------XX----XXXXXXXXX-X-----XX-X-X----X-XX----XXX-X-X-XX--XX----X-X--XX----X--XXXX---X-XXXXXX---XXX--X--X-X--X-----X-XXXX--X-X-XXXXX---XXXX-XX-X----XX---X--XX
