B---E-----E-?-M-B--MT-T------B-------??T-o-oB---MTB----o-----|TM?-X-M---XT---ME??---M-?E|-Bo-o--|--|-?BX--?-----XoB--?--B--X--|o-T--?---TT?--X-oMEM---X-EBT-|---T--X-T|-??E--TT-o-BB?--T----Eo?----|-X--
X-T|-|B-E---TEE?-|---ME-|MB--X---?ETX--BT|-XB--EB--?M---?-T|-?T?------?--------|-|E|-o-B-MoMB--B-|-M-------B---X-----EB-Xo-----E?Bo?--?-|B-o??-B?T-BE--?--EX-BE-T---?TB-----|--B-EM--M?B?---XXEB-|?T---T
--o---M--B|T----B-------E?---??T---BM-|--B-?----TE---|--T?oT-----|?E--BM--------BTE?---B--B|---oXM---E-|?MMo---?-B--?-XB-E--T--M?o--MBB------EB--M--EE|E-X-ME--Mo--|-||--?---??E-EBB-B-B-----E---------T
?E--?-----XX-B----Bo|-B---M--T-----B?-----?---|-TBB----o-----TE?------B-|----T---?--ETB-M---E-----MM-o--?|-?--M------ET-T-?-B-----?--|-E----BTT--XB--B--?-M-X-----?-?oB-B-EBB-o-??B-E-E---M?M-----E--B-o
--XET----|----M--?--|--X-XM--BEE-B--?B|-MX--B--||B----E-E-B-----M-----B--M-?---?T--?X-?--|-|----oM---M|B-EBBB---E|T-?T-M--M----M----M--XEE--BoB-B---ET---|--E--T-Bo-BBB--?---?B-|-T-o-B-o---T-TBME--BBBB
o---B|B--?-X---?-BTT----B|-----?B||BE---E-B---E?||-----T-?--------XTB-E---X--T-----|---BMTM---B-M--||--T----B-E---B-E--o--BE--B-M-B--M----X----TB?B--??--X---o--|-------B--TX-EX-M-T--BB-----BE---TT-?-M
TBX-B--B---------Eo---B-?M-----B---oBE-?oE-?-?-?oo--T---MM--|---MT-BM--|TME-E--|---|------X---E--EMBB--M|--|--|---E--BT---------B---E--XB--X----?---M-BX---M-?EBE?-|-M---B-X---B-BE-?B--MoMXT----?-MMoE|
TBE--MB-|-T---E?----?-X-XXBX-?-?T--MT?-Mo----------X--TX-X|E-----T-EB-M-?-M--|---|T-BX-XM-T?-B-?E----?-E---T|-MMB--E-?-?---|BX--MB---M-|-EX-|XE-M----EXT--B?-BT-B--ET---------B-?X-?--BX--BE--X-T--BE--v
MEMB------B-E--|--X-B------M--?-BE-E--E--T-o-|E?X---XoX-----X?-EM-B---TT-?|BB--E|XT------B--M-----|----|-MX|-E---oTBB-M--ET---E-B|BBMB-o-EB-X-M--B-M-|--B--B--o--?---E--?-------?---B-----BB?--?-E---?M?
M--T--B-B-M-------TT----B-------|---TEE-?-E-M-M|T|X--M---M-T--X--T-|-Mo--|TT---oo?-?-B---B-B------T--X--E--?----?---?EMT--M|TBXM--EX-?----M--------B|oM---EB-?E----T|?--|----o|----|MB---|-X--E-T-MB|--o
-|oT|--M---o-|B?-?---E--E----M|---o-?-----X-M-|---?-E--|oB-M---o|EX-X-|E--M?ETMEMo---B---T-TE--E-M-B-E--B---E--oE------BE--X--EB-|---T--BE-?-----BTX?----?----?XTXMT--|B-E----E--B---E-?------|?----XT-?
--B-T------B-B--M-T---------|-----E?|oB-T|-?---EoBTT------B-?--T----T-|?-B--||----|---M---TB--?-E--TB-|T----Bo----E|---EXEB--E-----T--M--E-E---MMM---EBXM----To|-?----M--|M-XT-EEETX-B-M-|---?-----?---X
X?--B-|TT--B--?B---|-MM-?XM-Eo-?o?oM-ET--E|---M--?EB--?|----M-|?-B----??|-?EBX-M--B?--||?----E|-T|----BT-BBB|--B----M--B--ET--BE----BB-E-o-BETTM-B---|-----M-B??XX------o--M----?--M|-X-|MT------E--|-MB
M------oEBX---E-T--?X--o--MM-XT--|---?-M|-T----B-X---o-M-B----XBE--B--?-E---E|-----T-----o--B-EB------BT|B----?----EXX------|-----------M-E-T---B-o-B-|--EB-|?--|-|-?T-BT--?-BM|EMX-------T|B-BoMM-----X
m-?E?-B-BM-B--|-T-?-T---|E---E---o-|?--M-M------|-----|----B-E--Eo--B-MM-X-T-M-BTTM|T--XTEB-EoBB?X|------B--XT--T--B-T--E--||--|TET-E-X-|B-|---X-BE--X|----B-M--TBB-|-BT|MB--MT--?X--|T-|X?--M-T---T-?-X
XX-----XXXX-XXXXXX--X---X----X-X-XXX-X-X-X---X-X-X--X--XXX----X--X-X-X-XX----X--X--X-XXXXX-X---------XX-XXX-XXXXXX--X---X-X----XXXX-----XXX-X--XXX----X-X-X-XX-X---XX--XXXXXX-X-X-----X-X-XXX--XXX-X-XXX
