M-MBEM-X---|B|-----------B--X----o-?EX--?E??EX-----TM--|?-BMB-EX-To-TT---------E-T-?--E--X-X-?Xo|--??T-T--o?-?--T-oX-T----T-----T--XX------oTT-|X-M-?-M?TM-E|o-X----T-M--E--------|--B-?Xo--M--M-T-XT-BE
?--M--XoB--E----o--MoM|-o-----X--?o-oE?--o----BT-E--|??|-----EXoT-T------E-X|-Eo|----|-XT?-|oT---EB----B?T--?E-|---|--X?----M----ETT-----X----M---?M----BX-MX-----M--|-BTTM-T-|-M--??-o-|TBT--E---o-?-BE
B----o-E|E--?B|--T--|M-M|M-X-M-BXX-ooEo|---XT--B-MMX---|------X--|o-o--M---M-|-T------X--oBTM--X-E-B-X--|TE-B-X-?-BB-|oM-B-X-o--T-MB-X-|B-E-X|T-----------E|----XMM----Eo-B-----X-?XM-----oMTBX-XoT---TM
|?---E-M-B-|-B---|----o-----oB-E|X?-------T--B|---XM-----E----E|TBo-MMM--o--|B-T-Mo|X-ME---E-|----XXo-T--Eo-T-T---T-|-MB|-------MB--o-B-?---------o--M----oX??---X|-|--o-Eo-ToE-?-B--|-E-X-X|-EB--X-E-XE
TMXo-?--B?o--M---|------X---TM--MX|-?-?TBo---|---T-----ooo--M--ME|-E?E|-----?-E-E|E--E-XE-TT--|X--Eo--TM----E-TEE-|B----T-E|-XX--X--T-T--------|--oT--Bo-|-E--X-o--?oX--E-E---------EoBT-|o--------XE-M-
|-oT--B-?X--EEE--?-ET-oE---T-ETX--Mo?-----?-|---|--??--E|-------|-XB--EMTM-?-?|--|--|---B-BT||XE-?X-X----|-|-ME|-T--MEB|-o-TX?------o--E|--|---M-|-X-o-T---o||--oo--M-----?--XM--BXXT------X--T-o-T?E-XM
T--X-BEEMTXT|-----o--EM---X-|MX|-M-o-B-M-------MBoE?---E-?----|oM-----T-?|E------X----X--B-T--?B?X--B--?--EBBXT--?-----o-X------o--|Eo--T-E-T---???--M-|-M--|XB-BB-------o------?-?------E-?o---o--E--TE
T?---EE----Mo----?----B---o-o-Eo??-B|-|--BMM|oT---??M-EM----M--XM--o--X-T-B?T-?-?|----E-----B?M-?oTX|---M--o|?BT-MT?|-T--|-o-o|---T--E-E--B--?BoEM---T--------X--E-ooo|---TE-M--E-X--?T|---M-ET-E|-?-oMv
-E--?-?B-B--M--B-X------E----M-?E--o---M-E?---?-|-oT--E----??-E-?-oBT--XMT?----?-B?-XB-?E?-----TB--?o|T-E----?E---|M---o?|----------X---EE-MMT-ME------|--Bo---X---?M-----To-ETBT-M-ME-T------M---MT---M
B|---X---------T--E---oo-X----oT-----------|-B|?-T---oBXETE-X-----------o-E-----o||E--TX-|-X-?-------M-E??X-EX|?|-XBMTB-M-o|-B------BT---o----BB--B--?oMM-TT-o|oE--?-|-T-?---------o|---X----B-E-X---?--
B?|-EM--EEoMM|--?ET?B?|-----oM|---EE-M--X---|?-o?M|X?|----T--ET-||-T--T-B|BXoo?-----oX---X--|-X-M-X-?-X----E-?----M|----EX-X-X-BE?T-X---|---XM--o-B-o-MT?--|-oT?-----o----?-X?B----Mo-T---Bo?E|---MX--Bo
EE-B-B---M--T---o?--?|M-|-|--?-M-TBMB--E-?----T--Eo-X||-B-E-|-?B----?T|--B----X-----|---MB-|E-----B--BX-?---X-|T---T--o-To-T-?-oB??T----M?T-M|--o-XB?-??-------|--o--o-X------M-----BM|X|--|---B|E--B--B
?o|-oX----EE----MEM-T-XX|---T---o----?--B-MTo------|-?BB-o--|-T?----|-M---B-----XXXXo|XE--|---B-----M|----MT------|o-o----X---oM-M?-----|-o-E-|B-E-Xo-----o--?M-----?M-?---E-X----o-XB-------T|-EEME---T
?------To--o--M|-oB---M---|---T--To|-T?EoX-X|T---X|------T--Xo----o-|-?M-E?-o|--|X|-M?XM|-o---TT|-T-T---oM-o---?--|-X-T--MMBo|BE-B-E-|?-EoE--oX-|TMo-T-E---MBMoE---?ET-?--BEB-|-T-X-XMBo--?---|-E-T-T-B?
m|--M-M-----o------?M--|----?M---BM-?X-|----B-|Xo-|-E-M--E---B--BE---T|-?T-XEEB--?---|EB--XB--E--X-----E-B--|-EXT-E---TX---X-E--E-E-X|X?X--E-ToT-BM-E-TBBXToMMo|--|X----|MB--B--B|E----?--X--EX--?-E-TXo
XXXXXXXXXXXXXXXXXXXXXXXXXXXXXXXXXXXXXXXXXXXXXXXXXXXXXXXXXXXXXXXXXXXXXXXXXXXXXXXXXXXXXXXXXXXXXXXXXXXXXXXXXXXXXXXXXXXXXXXXXXXXXXXXXXXXXXXXXXXXXXXXXXXXXXXXXXXXXXXXXXXXXXXXXXXXXXXXXXXXXXXXXXXXXXXXXXXXXXXX
