X-T--|?TMM--TX|-B-?--|---EE--|B|M------o|------?X---X|-----------X---B--To--E--E-X-T|BT--|BX|--------M|BMo-T--??BMX--B-----|-XT-XE|--o-X?---|--EM--?---BT---|----X------TM-EX|-B------M---ToT-?---E-M--o
BXE-X|-?--XT-M-M-X-E-----|-?--E?EX-?--?-EM-B-TMM--E-o--|o-M|-M-TB-|-?B---o?-M--XBX--?--o-X|E?-M-M---MB-------T-o--o----|-?X-|E----M-o-------E?|X?|T-E-T---------E-T--o---E---EX-T---M------------------E
X?M-BTE?oo-B-o-M-|BB--oT|----MX|----X---|E-E?---B--?-T--X-?--X--T-EM--|-MMoB---T-o?---Eo-T---X-------B--X--EXo-EMo-?M?M-E-E----E--MM--T-B---|?-EB-T--MM-?T-ET---o-?-----o------BT-?T-E--M-o-E-B-B--BT---
-MX-Bo?o----o-EM----oo-E|-----------?|TB-|----oB---T?---E-M-------?--|-----M--XME-B--?--|E|M-B---X-M-o-----|--MB---o--?BX---E-----T--T---XE------|--|E------B--M-E--M--EX-------E--E|-TE---B?------M-T-T
XEME-Eo--T-E-X--E-?--B---?E-EX----Xo-BM---------o?---BTXT--?Bo--|XXM--o-E---?-|-MX---?------||--T-|--B---M--M-E-o--M-|--E|MX-----?ET---XXME--T??M-o-ME-oo--M-E-oX--E--TB-|--EEB?EoE-?---MEo?-?o-|-T--M--
|-X-B--B--T?-To-XMB-M-?-E--|o----M|-X-T-XoB-X--E|--BT--T-X-MM?B--M--T---T-o-Bo?-M-B------TT---T--XB-E-MXX|X-B---M---X--------XT-?-X-?-M-E?----?--E--MBT--B-----B---TXTE--ETE?--X-M--EMB-BE---X-?M-E??-?B
B-?M-----?----?B-TBT----BB----|---X?o-oT?E---oXT--|?E--T-?---XX---------T--E-----TX?-XX-|-E---X-BE--T-?T--?T-T------T---T---B----T--B?-------?-TM----T---B--X--E-M----|--B--o---E--B--?------T-T-M--EET-
T-B-EM--E|-To-T---B-T|--T-?B-oT?X-?--T-----|--T----T--BT-o-MB---E-|---M-oMM-?-T--TX|XB-?-T---Bo---TE---??-------|----------BoBoM---?--E|-oX-XE-|---B---oE----?-o-------------|---E-----M--T-----o|X--o|v
----|-T----XBE-XE-o?-T--?-T----o---oM---o--?BX--|-M---T--?-X---T?|----X-?-TB-TE-XE--o|TM-|B|ToM---------|--M---Mo--X-|-B---T-B-|X-MoT?||?M---oX-oXoB---|-T---E?--X-----B-----T-EEM|M-E---o-B-o--To-T--|o
M-|B-o--?--?M|--oX-X-Xo-o-?-E-----X-B-|-|o--?B-Xo-T-X-M-TMBX-|XTB---X--TT--|EB-TX-M--T----?-BX----M|o-|-X-Xo-BME|------EE--EM-E--T----M--|-|-|--M-o---oM--oo---B--------T-E-|----MB----T-?--?X--X---X-E-
E-?|---?|-MBoBB----M-?o|-?--?T?T-------X-T------|-?E-M--?X-o------Bo---|BBX-B----BoT---ToX----oT---T-----?--T---E---M--??|?------T|--X-EBX-M?X--XMM-MT-X-X----o-BBB---X--ETE|---o?---|X-M?X-|-o--o---?-X
M-----?||B--To-BEB??----?MBX---o-X|--?T-MB-M-B-E?TT-|M-------M--BXE|B-o-B-?-B|-E---EEX--XE-----BX--ETE---BT---X----o|-o--T-MM?T-oB--B|--T-XTX-BX------B-EE-|XB|o--E-----EEoX?o-MMMB|------XB----|-?|--M-
-oX--X-E-EM---MX--MB--Mo-|---To------o----o-BB|T|-B-----ooE------T--|--B??-BXMMoT??-TXT-T--T-o---M?---TEE?--T----T?EooE-?-|---B|--o-BM|-|-X-o--||----MM--E-M-X--B---?Mo------oM-B---BT-M-oEM--?MMM|?o-T?
TE--B-EXMBMo--B?-E?|--?---|?--TT-o--?-M-BEMT-?--X-o-Bo|TTXXT-TX--XooM-oX-----X-?-?-----------T---T-M-|MB?M--EE|--X?--BT?M-XX-T?-X-T-------o--?E?--?-|-M---TT|---|-o??---E--ME--E-X---?----B-T-|?----TT-T
m--?|X------|T?-T-??----|-----B-M----T-|-|-o--o?TMX-ET|---XB-o?E-|-T-M--oTM-B--M|-MT|TE-?--|E-E--E?--TB---B|-M-TB----------E-?|--X-E--M-XXE-oE--?T-B--M-|o-?-o?--MXE?-E-M--TM----oT--|-EBX-----T?-T----?
XXXXXXXXXXXXXXXXXXXXXXXXXXXXXXXXXXXXXXXXXXXXXXXXXXXXXXXXXXXXXXXXXXXXXXXXXXXXXXXXXXXXXXXXXXXXXXXXXXXXXXXXXXXXXXXXXXXXXXXXXXXXXXXXXXXXXXXXXXXXXXXXXXXXXXXXXXXXXXXXXXXXXXXXXXXXXXXXXXXXXXXXXXXXXXXXXXXXXXXX
