T?X-E?-M--o|E-|-?|?o?T?o-?B?o-X-MTEo-XTo--???B--M-B?-T--M----M--o-|-|--X?----B-?----BXT----M-E--o-|BT--o--E?M-|-oXMo-?------T--E--BoX-M---E----?BB--o--XB-?-|-MX-T-BB--E-----o?----M-|------BMTME-|EoB-?
XX---BMo--?---EE?M--T--|?o--TT-??-o-M-BMT-X?BE|T--B---B-M-----E--T|----B------o-?-?-|--B-EM----------oX------|B--B---M-B-----?-----MMT--TE--XM-----E-|TT-ET--|--B---??o-M-B-|-----|----ME?T-T|-X-X-----E
B---TT-E-------o|-B--BBB-|-E-T-----X--B-B-M--|----E---B-E-----|-B|---M---Bo---M----|-?---B----T-T------ETMo---|--|EB-|---Bo--?--?--------o--|--B----BB-MM--------o-?ETM-----EX----M--EE-BMo------M-X--Mo
-?X-BM-T--|--TT---T-BB-BB-B----ME-?B?B-B----M---B------|BT?--|oM--?----M--T----?----B-B-M----B?-----oM------?-EXM-?-----M------o---?E---Mo-TXT?-|--?-BE--BTM------E--E|---|E-?X--T---E--|--E--o?TT--M-|T
E--M--------X?-M|--|-?--B--BMB-|BB-?-XX----M--?-?---|-?B--T--B--BE-?-||-B-E----BM-M-|-B----T--M----T-T-|--?-B---B|TT----B-|E-BBT--M|-|-?---|---M---?B-T----o--|BBX---B----T-|T----M----?--?T-T---------B
---|--BE-B-T-----B---oB-|TM---X-----T--E-M---|-|-MMEM-BTM-??--?E-?--|------X--T--------M?E-|--T---BB-M--ET-oX---|---?--EX?X|BM--T---B?-----TB----?M-|X-------T---XET---T-------?|---?E--TB-E---E-T----ME
o--XM--B---M-----o?T-M-T-|M?B-E-T-MB---B-----?-BT-----M-T---E--B---B-|?--T-EB?-o?----|o---TM?--B-------MM-M---B----oEM-BTE--M-T----M---o---E-----B---|--B-X----|---E--o--B---BB--o---B--|TT-?-B---?----o
MT----?B----M-T-B----|---T-E-M----X---E--T---oM--M------B--B--M--o-o-B--E-E-o-B--E-?T----M--B?-E?B-B-|X----MoB---?-----|E-M---X----||-M|--------MTM--M--?E----B-----o-BMT-|B---|--MX--TTM-|-|oBE|---B-?v
o-T--E--?--E--M-?XB-o-?---|-----Bo-E--EX-oM---TTEM---M-B-E---E----B?-|---EM-oE-BT-o-BET----ETB?-X-T-----TM--M------------B-?--|B--?-M---T-T|X|-EoB-?-TM---T|-?----EB-----?-|T-------EM-E-T---|-|?|--??-B
X---o---E?-M--oo---M|-----B---------XMM--BE--M----T-E-XB-X|--E-B-XT-B-----M--X---BT|---?T--B------|--TE-B---??M?X--E---B|------------XBB-|B-----?-|-?XX--M-|X-E--M--BM?-E-MT----o-T------B--XB------oB-M
E?T----B---MT--E-?-XE--MEM-XM-B?o-BT-T--TX---B-?T---?---B-?T?o-|T-?|---?--------TT-?--?--M--M?--|-|-BB-?X----M-E--M--M-----BEX-B-T-M-B-T-MBoX--X|--|MTET--TM-|------------T----M-----|B---E-E---MT-----T
M-E-B|??EE-------o--?|B-o--B--B---|BE--ME--T-Bo--E-----?-------Eo?--B-X|-E?|M-E?--|-E------|-X?TTX-E-B-------------T--?B---ET--|-------B--B-------|-||T-B--B-?----E--X------TTT|--B-|--EX----BX-M---?-?-
oBEB-|-|----EMo--?-|--B?XTM?-?--M----M-E-MBXX------o-?---B-------|-|----?--B-B---T|?--?E-B|-|-oBB?-|X-M|-X-B---|XMT--BBX-BT---B-T-E-T--?|B--B-|M--E--B----M----B---|---B--MoT-?-ET|-EBo--?---X---M---B-E
B-TT--|?X----------EB-?|oXTB----X--B-T--EB----T---XMTBTT-B--|-||-ET----E--?M-E---BT----|----T-E---E----??-MEE-TE--|MEo-?T---X---B----B--B---B--?----B--B---|TE--?oT-?T---EM?oX---B---EEE-T--B---o--?BX|o
mB--|?---E--|BBT-TEMB----T---B?--?TBB-T|------B---------B-?-M?B---B--To------T-B-|-?--?---T-X-M-|B-----BM|--T-B-----|?|---?TM-------XE-E--o---B|-|?-----?EE--|-o-B-|-B--MT-T?B-EoB-----E?------XTB-B----
XXXXX--X--XXXX-XX-----X---XXXXX---X-XX-X---X-XX---XXXX-X-XX--XX-XX--XXXXX-XX---X-X---XX-XX--XX---X-XX-X----XX--XX-XX-X-X----X-X--X--XX-X-XXXXXX-----XXXXX---XX----XX--XX--------X-XXX--X---X-XXXX--X-XXX
