?X-|X--M?-M-B-T----X--?-|o--?|Eo--XB--T-BBBEXXB---E--?--Bo----|o--|------|?-BX-ME?TM|-T-T---B-TX-T----?M----XXT|---oX----BE-?-o--|M?-|--ET-?TE-oT--E--B--o-EB-B------MB-T---T-T|-|--T----X--T-----M-B-To
E|E-X?--X-MM--|----|-XEE----MoX-Bo---E-----TT--T-B-ET------?-X-T-E-|--E-?|?X--|--TM-|-E|-----o---?EM-oooBMoE----?---T--T|--?oE-o-|?-----?-o---Bo--T-ETE?B-o-M-|-M--o-X-E--M---XBT--Mo-Mo-----|?--T----oB
-B-------T|X?|-Bo-o--E|MB--M-----|-oM----?B-ET-o-o--o-B--T--B-----T-?-M-T-XME--B-To-?-o----??---T?ME-EB-||---E-ME------E---E|T----X--TM---|-|o--------E--Xo-oM|EoEo-|MT|-X-----M-?|B--T-T---?-B---M-B--|
M?MMX--B---M--X-?--T---T--BMT-------M-?-TB-|-?oXT-MXXE---BB---oB-------B---o-T|XB|?--T---X----|-o--------oo-EX---Xo---?B---TB---XX-EX-E----o-oo-M---T------??To-B-MX-MMET-|----E?--BX-X-|---|-|--??B--X|
XB--?|X-|-oE---o-T-T-|-|--|--|---o--E--TMX-MT--X--oo-----------||--E----T--------X-Moo-TT-TME---X--EXMXT-????--T--T|MMT?o-M|--|--|-T--E---T|T-X---BM---E-----BT-o-Bo----?-|-E--|M-T-M--EME--TX--B---X?oX
BoM-M-Bo?--BX?BB--o----M-oT----o|X--EX?---oX----B|-XX--B--|---|X-X-M-|E--o?--?-BEE-M?--BT---E|-|--B---?---E?-?-M--???EoMoo--M--|--|M---MB-ETMB-?X-B----M-X--M|T-?--?-T--||---B--oB----X--E-----?T?M-M-B?
|M---o---BX----oM?|---M-B--M-----o---T-TM-E?T|-B---Xo-X?T-M-T-?oT-o--B-|-|----EXo--------E-?M-E-BM|B?---?---B--o-oo--ETB-----B|E----MM----oTMXT-M?M---M----T------XoB-?XM--X----E--X--?--T-E----?-M---|-
-|?EMB-TT---EBX-E--|-BBX-?EM--B|?X--B-|E?-M-TM-|-TE---T-o-B|oTX----M|----------||-?-EB-oB--?-MM-|-----T?-TT-MTB-M-T-o--|X---BB--|?Bo-o-X-----|||-------M|--MB--X-?--oo--???o--Xo--E-o|--XB---B-o||---EEv
TE|--M----?T--Bo|-TMB|---oXE-|X|----B--|---X-?---MX?|-B--o-----BM-M---o---B-B--------B-|-XTX-MXT?E---M--M-----B----|-B--|?XE?-X-E-----X??TB|E-|MTTo-TM-M-T---B-------------o--oTo--T-B----E----T-?X-?-BT
-?--T---E----?-|---X--?--T-oT?o---TTM----X--E--o------Eo-B---E---ME-Bo-B-T--?-oME|ET|-E--?-------o|E|--|-T|?TTE?--M?oo----To----X---B--?-T-o-o-E-?--X---oMX--XB---E?|???Xo--?M--oE-oM--|----o----oM-E-Mo
BE|-o--MEo--------?-----E--E----|-T-T----?-TT-XT-o-T--?E-o|-----|BX--T-------X|--|T-X-?o--?-B---o-----M-X--E?---------o----|---?--|T---E------B-----E---BXX-|?B-B-M-|------|----X----E---|?--Xo--|B-T-BX
XT-B-|-----EX-o-TX-E-oo----T--M|--|----BB-?-XX?X|-X---oX-B|T---X--MoE|--|---?|----EB-E?-------T?T--------B?---T---o?--MM--ETEB-B?-X|ToE--??-?---oo--oBo-TXX-------E---X---E---MX------T--o--XB-T-o----Mo
oE-X---X-------?-M--M-|-------?o--|oTE-----T-?---|Xoo---|B?--|E|--?-B|M-----X---E?B-BE-B--E---M-T---T--oM---|----E--?---T--|-T-XE-To--B-|E----BB-TMT-?-|-----B-Boo-B-BT--oMo-?-|B---E---TXT-----BXM--XXo
?-|------B|-o|X?X-Mo-X---To---B--BBTB--?|---|E----EEM-|o----TE-XE-?--MBX-----?|-|---?--B--ME-?----|--T-Xo-B-X-B-T---E-?-------oEo----B---o-X-T-M-oE-E?oToT--|X-EE-TB---|-TB------Bo-X-----X-X?---oE-X-X?
mM--M------EB-------X-X----|-----BM-----X---?B-EB?EX?-T--T-B--XoM-X--BE|-X|--oB??B---EM---|-XoM--|--X-X?-M-BTo----T---o---o--X|------T-oTB-B-|-TX--E-BEM-|---?-o-?---E---T--?T----?|--|-T--|--o-?X---BEB
XXXXXXXXXXXXXXXXXXXXXXXXXXXXXXXXXXXXXXXXXXXXXXXXXXXXXXXXXXXXXXXXXXXXXXXXXXXXXXXXXXXXXXXXXXXXXXXXXXXXXXXXXXXXXXXXXXXXXXXXXXXXXXXXXXXXXXXXXXXXXXXXXXXXXXXXXXXXXXXXXXXXXXXXXXXXXXXXXXXXXXXXXXXXXXXXXXXXXXXX
