Eo-M---BETX-X-TM|-----T-o-X|T-?X--oB-X----E|---|E?-?o--E|BMX?-o-X--X-----M?-XM?BBEX?-MBE-|--------Mo---?M--Eo-T?-TT-B--TE--E---------EM--X--XX|B-----T|ETo-M-T-M--|?E---?--?--M-----MM-T---X--oX-?---o-|
M----|-M-|E-?-T?M-B--o-MM----T--MB--BM---TXE------BEMXB-BB--M-B------|-oXE-----E-ME---|-M-------BEM--X-MX------T|-X-?-----BB--oB--MBBE--MMX-?M-E-----E?-----X----X?o?------------M-MM----B-EE--XT|--BTX-
T-?---BT--B-X-EB--??---E-E---?-o----BX-o----|-XTX?--M--?--T-E-X--oXBM---T?---XME-o-MB?oET-EETE?T---X?--oX-T-M--B??---|EMMM--MTBo----T-EET--TT--o--B--M-?B-B-B----MMT------------M-|B--T?-B-E-TEToX?-|-B|
|---B-|T-M-B-?XT-XT-??-M?B?BM--B---M--E-B?-TE|----|--M-B-?--T-M---B----T-E--M-o--B----?-?-M--XB-E-B---BB---?---B--B?B----?BB|-XB--M----oB------B?-o---|--|---M-To-|X?XEM|-B-BB|-EMT----o-TX---BTT--B----
T-BMXB--E-|----B-|-|?B-X?-----BE--T----XE-EX?---XoTM---B-X?|M?-X---E----|--XoBT--E-oX---BM-X-X----?-----M?-BX?-----M?B-|T-|-B?X|MX---M--MB--M?---BT----M-|----B-TEBT-X--------M--Xo----?-??B--EXEX|X-?B|
E----X--|-E--B----?-M-T--?--|-BX-EoT----|T-|o?-T----oBE|--|-BT|----B---B-o-|?X--M----TE--oX----X--EX---BB-BE-E----T|------TEB--|M--M---|T-------X---B|--TETB---oTBMX--BB-oB-BX---M?--|--|E--?----|M-ToT|
|---oo-ET-|B--|-?BM----X|---|---E---|MME?-B--|?--XM---X-?M---M-|-|oE-BE---TX-E-T-ToX-M-|E---?|---X----B?B--XE---BB-T--X-----B??|-Mo?---B--T--------B-BM-----X---T?TX?--||----?XM---||-?TT-M--T-E--ME|---
Bo-----X--TBTo|X-X|-o------EXB-o?BToE--?-oTX--M?o--o-|-----EE---E--T-X-T-T-X--MX--??-X--o-?o-BX?-|MB-||?--|-M-------|Eo-M--B-E-M--T-|--BE--ET------X-|--BoXM---MM-M--?-X---E--?-?-M-Xo-?---?X-M?-|-o|--v
B-----XT-EEX?M-BEX---EMo-?-BMBX---BXB--?------E-|--M-?BB--?X---M----B|--E-|X-TX--|---?-TB?---o--?-T-E?-----------E-E-------TB-BBX?--BX-M-?-|-E---||-E---||----------oM--XBBM--MX-Bo-XM-E---B-?oX--BTX|-B
|-M?-B--B|-E-|--?B-M-||---B-B---B-X-?------M----E--o--X-?--MTE----?-X-B--B-B-oXM--T-T?-X|-|-XB?TXB|-?B----X---BB-X----B|o--XE---|-?|--o---B--E?-?--|--B-MBMME----|M-B|ET-|---?B-?-E--------T-T--X-|-B--?
o-??E--EM-?--T---M--T-X---?---???---B-B-------X-B|-EE--TE--E-o-M-|--B--T--E--oX-M-T?XE-----?X------|To---oBBE--?-M-E--XM---------o--X--TM--TX-T--EE-|T---??----E--|E----T-?------|?-------TBBooM-M---?T-
?BB--XT-B-X---BE----|--TM-B-T----o--T-E-|--------|-?T---|T---B-----?--------X--o-|BBTX-EB--|----?-BM--oX?---T--EB----?M---------X----X---E-B||-E-?B-BB-?|---T-B-?|-T--T?-B-?EM|MT----T-?---?---TT-T-oB-M
B|BoX-X------EB|-XBBT?M--|-EE--??--X---B-ET-BB---E--M-|X-MMB--M-M-XB-X--E-----?M-XT-?X-X--X----??--X?oT-M--o-------o-T-------B-M-oB--MB-BBE-o-oE---E-B-?MX?--T-X-T-oE---MBTMoXETM-?-|-MT-E--M-o|?X?BETXE
|--T-|T----|--o?Xo|EM?---B?E-----X--M-|--ME--E-----ME-?-XToEMT-ET-|---B-oX-MBB-o--XB-MEB-TET-XM-E-o--oM|-M-M-T|T------EBX-o-X-X--?--E--|EB-oX-??B-X----TB?|-T--?|E-M-----|B-|XoB-M--B-|--TM?--|-M---|EBo
m-|---|-EE-|ME----ME-------B?-BX?---XM--BMBBME-?-MT-M----EE--ET-T----M--MT-X|?--TE|-TEMMM-M---|T?TE?T|--M-?---T---E|BBT--|X-??oM---MXM----------o---ET-X--M--B---|E?--B----?T?--B|--|-------B--?B-B--|M-
X--o---oo-oo--o--oo-o--oooooo-------o-o-----ooo--o----oooo-o-oo--oo--o-oo-oo--o-oooo-oo-o-o--o-o---oo---oo-oo-o--o--o--o--oooo---o-ooo-----o--o-o--oo---o---ooo-oooo-o----o---o----oooo-o--o--oooooo-o-X
