X--T--B----B--B-?-?-o---?--M?-E---B|-TX|-BB-|---------XE-?X-E--?---?-?TEBE--B-?--|---BX-X-E---------E---T-B?-o-MX--o----??----|-o-XT-??--MEXo-?o----o?--XT--B--|Xo-E--Xo--|-----oT--?-o-B-X-oBB---BM--o?
T-E??|ME----?-T----M---MM-M-M-|--MX?---EB---|---E---B--?E---|-|--------oEXE?M---XM|---||B-M-E?T-TB--M-XM?E-T?-o--B--?BBB----|E|-B---M-B----MBB---?-----M-?-B-|-E?X----Bo-T--B--Bo?-M--?------M---TE----|
?BMB--oB--BBE---E-E---B-B---?-?----M-X-------EBo--T--BX-?-B-|E-oB-oB?-B-T----------M---?--M-B---Bo---|XE-X--------T---oTT---M-M?-TB--------EB--XT--|--T--MT-B---?---M--M---?----o-T--?|B-E----B--??---XB
oM-BTE-o?B---|Bo-X---E?----|X--oT--T--------B--o|---B--EB-|ET-E|-|---?-?--?|?-BB-X-EEMM||-MMoTB||B|M-|-?BTB----BM-|M-B-?-B--T-?-|-T--E-M---|o-T-----oT--M--X-X|---|-----X|--X---M-M--X-?ET-E--|-T-----?-
XB?-T-E-X|------|--?---o|B----BT--E|||-?-----?T---o||TM-M----MM---E?-?-T---MT---|E----TB-E--TE-M--EB--?B-To---T?-o----o?--X-EBTE-----M|-?--MB-|B-E--M--E-E-X----X--?---?-E---M----B--B--M-T-TT--T-?ME-BE
BB?o-T|--B-------B---T--X-----?----B-----?-----??-X-|BB?--TB?--X-?-T---TMT----|---|-|BT-----E-o-?-XE--M--ME--TB?--X----EE---|-B----E-TB--B-T-E-M--T--B-|-EMX--M--?---|---TB----o----M?B-------X---M-|-TX
----|---|-TT-B----EMo---B---|o-|E-o?E-B----M----ETEM-MT?M--o-T-T------TE----EE-E------B---T-M---E--BE----TT--BBT|M--B|oTM----M-?T-----T-B|-----B|?---o-|-X-|-T--MX-?--TE|E-B---EB|TB--|--X-o-EB--MX----T
-------T-B-------?-T--E-----?XT--MBE--B-X-M-M--E?-EE---BEMT-B---?--B|T---||---?-E-?M---?-----T---|-B-MEM--M----|||----------T----B-E-?---oE|---o-oTX-|-B------MEB-T?---M-X----E-M----B-M----E---M------v
M----?oT---T---?--X---B---E--?-----X-M--BM------B---XBB-X-o?--?--B--X------B-BX--TMT-TB-|---?BEBEM-T--E|E|--?B--TM|??---T---M--X--MEBoT?--?-----|T?-B--------------EBT-T-X---BEB--TB-E--B--T------?-----
---------Bo-BBB----E--X-|---?-E------?-|?T-oMX--oM-----|-|--M-----|M---------M-MBEB-B|--?B--|-----B--X--BB-M-ME---T-B-E--ETToB-o-B--BM---|----T-B-B-?-B---T--M?E-TTE-|-----B----?------?--BB--|Bo-Moo-X|
X|B?-E---o|-----BM-------M-|---TB-EBBEX--?M---?MTMM---TEM---E-XM?--M-E-X----|----E?|---------EE|-M?E--X?-T------B--T--E-B--o----T--|?||T-----?-TTET--E-|--M--?-----B-?---?E--B----M-|E-EB-M?---T|---X--M
E|-T---B--------T---E-MB-E-??--E--M----?-?-T--T----B-?To-------E------E?--------|X---o-X-B-XE-B-|B--EMTB--?oB-M-|--|?-EM|?-MMT----BXE-MXMB--MMT--TX--M-X?-|-o---EB-B-BM-XMMo-M----B-MB---M-B-------o--|B
|E---MB---o-BE-X--?-BE-?---|-XB---X-?MT--T----------|-X-BT-M-TEE---T-TT-M----E-?TT--M----E--BM-----E-M-T-E---X-B-?--o||--T---E--XM----?E-M-T--E----B-----oM?-BT---B?--M-ET---?|?-E--TT--E|M---T-B--|?|-X
|-------M-?M--Mo---T--E-?-|-M-B-?-BB--|----|------?--?o-T-?-T-E-?----E-M-?|-??M-?-B--E-M-TT-------B-M--|-|---MX-----Bo----B--||-M----M-MM-|B-?--X----o---MM|---M---M|-B---E--|B-----MBX-----?|-----?---M
mEB-------BE-EB--|E-----X--T|M-----|-To----T-----?|-B-B-----?--|-----EM--E|-X-B?|?--oEBM--TM--?---?--|E--T-T||B--M--B-|?---|?---EMM----T----M-----TEMM|E-E--B-ME--o--X--ME---E-oT---BT--M----B-T-|--||X|
X-XX----XXXXXXXX-----X--X-X-XX--X--X--X-XX-XX-X-X--X--X-X-X--X-X-XXXX--X--XXXX-X-XXX-X--XX--XXXXX-XXX-X-XXXXX-X-X----XXX---X---XXX-X--XXXXX-X---XXXX-X--X-XXXXXX--XX-X--XX---XX-X-XX--XXX-X--XXX--XXXX-X
