M--E-o-XT----BX--X-M--TE-M--M------T--TB|---XX--M---|o-T--E-?-?T--B--TT---T-B----MMEMT--|-E---?-EE----------T---?E--XM--M--------oE--?---?--|-B----BX--X--|-o----------M----------o-X-o-?-Eo-XoETE--XX-B
|EB|-E-E-?Eo-M?---X?-T-|?-|-|--B-----B----E------?X-E--?B|TMB--M----E-T-|-MM-?Bo-?-|---ooE--o|-B--T---X?--B-?-|B-ET|X-----T-o|?BBX-E--TT-?MM-T-B-B?-|-M---TB-?-|--X-|--|--T-T-B-T|B---M---MB--M-?-|-o|BX
EBT-B-----T-----MEB-X-------E|-----oMXBX-EoE----X------o-MXM-M---TX--E-BTE-o-E---|--B-----X-EE-?E-?---MB-TM--M--E-?--o?---X-o-X?--|---X??-------M-BM-XBBT-XB-?--------B-o---?-?---|--?MBE?--o----M-o-X-|
?-?-E---BEM-E??E-|-o-o-BB-BMB-B-T-X|---oE-BB--E-ME?B----B-MBoXM-----T?B--|B---E|M--EE-BoX-BBE--o-X-TBT|-Bo--T?-B--?o---o-M-X-B--oE---------X-M-X-M-BEB--MoTM---M-|E?--BB-----BB--T--M-|-M---T---T-BTMX--
oEBBM-BX?B---?B----T-M---||------|-BM--EB-|----?|B----|-E------oX|-T|---|-E-TB------|-BMBBE--ME|XM-B-------E-M-------B-MXM-?||-----o--B--X-B-|--X--XTX-B-X--B-||-BB---|ET--TT-BM-|EBM?---M----BB--o-X?-B
-----T|-X-M-|oB--o?-TB-M-B--o--T|oBo--EB-E--M-----X-M--E?-B-T--B---T---XE--M----X----X|--?T----E?----T-o-------M--E-B--E?oXB-X|-?T-o-|-|T-X--?MXE---?--BT--B|BTMBE?---|-XTB-B--BB---T----M-BX-T--TT----X
?-B--M--X-B--|-M-X--TB---MM-MM---T|--o?-----TToo|----TT--TE-BE-------B-?-T-B|-XB-------B--T--M-X|TBT--o--o----X--B-----X-BE-----BBXBE-EMo-B-|X-----?M---M--XM-|-E---TB-|-MToE-|-T---ET---XoX-T-TX-|---XT
TX-B--BB-----B--------|Eo?-TT-M?oB-MX-M|?E--ET-|MTMM---o-------?--X----B----XT--o-T------oo---T--?E?---?-----X---|BBE|--EMMBX----|o-E--?--?--T-M--|----MoBM-T?M|?TEB-X--M--?--?|-ET-E---B-o-?-MEM---BM-v
B-----BBB-?-o-o--|-X?--T-XT|-B-M-?X-B|T-X|B----TB-EE-BEX?--?--?MEX|-------Bo------?--BB-E----------T--E-MBEXBE---B--EX?B--MEMo-?BE-BB-MX-XEXo------B-----B-----E-X|----|-XB--X-B|E-E|----MX|B----T-T--Mo
----?TB---??TX-B--E?o?-TMB-------o-|--B-M-E-BX----E----XB---X------E---|---?-B--MB-TT--EE---oB--|------|----B--?-----Mo--T-oM?-B---|---M?X-E----M--oM-X-?ET-M--?M?--X-B||-M-M--E|M-----------|X---|-E--o
X--TX-X|--T-|--TX-T--T--TETBT---MB--|o---oT|-E|X-----??-T--T--EBT|E-?X--E--TB?--T?---|--?B-----B---|--X---MEE-o-M--EMBE|X-T-?-?--T-|-o--?X--T-o|T-B-?X-?---?B-BB?E--B--T-----M--BB--B--?-o--|-||o--?X-EB
BB---?---M-X--M?-o-B-o-?M|---M-----BBB-|-o|oT-?---|-o|-o--B----X-M-TB----B-BT-E----M--|-----TE--EBB-?--?-----T-M---B-T-T?-B----o-MT---|-B-B--B--XEMB----?--|B----T-o--MB--|T-T---------T--M----TT---B-??
|T----TE----?-TMM-|-|----T--|B--B----|E-o--oX-----|oo--M?M|B--|-TTB---?--E-|-M--BE-T?T--EB--X-o--|-E-B-Eo-BB--X---B--|------|-?-T----|-M-?---E-X---|--ET---T|---MMX----B-E|X-?oBo-X-E-?|----?oM--?--?-B?
B-B-|X-M-T|--TB--TBBB------T--------X-?-??M|------ET|---M-BX---T---X|-ETBXo-EE-T|-TX-o|oXMB----B-------|--|E--M-B--?-EE-----TME-----|T----X?-----?--?---|---oXB-?X-E-B---TT-B-----?BoE--ToXMT--X-----B-B
m--X?M-?|?--XEB----Mo--?--MX-----ME--?---ET-----B-|--M---|BX-------Xo----E?BMT-TX-BB-T-BE--X---E?B-M--B-----MEBE----X-E?BM?--B?B--X--?-X-?o-----------B-M-EB|TB----M--?---E-----?B----|-----T---M------M
Xoooo-o--ooo---o-o---oo----oooooo-ooo----o-oo-oo---o-o-o-ooo----o-oooo-oo-ooo-o--o--o-oo---oo-oooooo---oo-oo-----o-oo--o---ooo-o-o--o-o--oo--o-o----o--o--o-o-oooooo-o-o-oo---o--o---o---ooo-ooo-ooo-o-X
