X-M|oBX---TMB-B--o--TM-oT--T-E------X----E-o---MM-?ME?----o---BB--TM-|----T-B-------?XoM----oXTX----|-|--E--?E-|-X--|--o-M??-M--?B-----|oB?B---|T-X-|-|--E--oE-|-E----M?-E-E-?--T---?X--|-?---TX-Xo|M--B
XBo-o------o---X-E?X--X--BMB|-|-B|||-XB-?|--?--------B---X---o-|-T----BT--T--?-B-o-?|B-M---?|-B---?-E|---E--TBo--ME--BEE--|-X?EB--M---E-T--MX-|B-X-|BMM----X---?-?-EBX|X---BoB-M----?----T--|--X---MET|B
TB------B-B--|oX----T--E-E|BTXTTMMT-o-?---M--X-E--E--E-----|X--BBT-----B-?E--B?X-----|XM-----E?oXM---X-B----EE-?|-|-|o--MXo-oE---?|-X----?-B-E-M------T?-T|Bo-|--T?E-Eo|--BE---oM--T|B-|B-?E-o----BM--M-
E--T-XEBT---ME|-XT-M-M-BT--B---?E|---BBTo-B----B--oXM------E?|--E--|B----B-|T----?E|---E----BB-o-M---B----|?--EM-B-B-E??----X---MTX||--T---|BE-MMM---EXB-BE--BEBB-XB-?----B-?-XT--XM-B--T----E---T-XT--o
oE-T--------X--E--EBE--|-X-oE---?--?---|B---o---E--?-E----EMX-?|-?-oMX-M--E-?--M-B--|?---M--?EX-X--ET----|----BX-?--|E-TE-BXT|--M--EB--|oXBBM|o----|------M---MX-X-EBE--M-M--|--TMXBME--TE-XEo--|B-|-T-o
o--T---EM-B-|------|-?M-TM?-B-T?---M---|---E?E|----BMEMo|E---|MX-|?--B?-B---BBB-oT---X-B-E----E-?-----MB----?-----?-|X----E---------?-B-?--|EBXE-B?|---T?|-----M|-|BB---M-----T-EB--?M----|-B------X-M-|
----EXB-BTB---M-B-X-|||---?E?-X-ET--ME-EB|X-|-B--MXo|-XEX--X--B--oT-?|?------------B-B--o?-X-X----X-E--B--E-?T----?B-BX----?XT|?---M-----??--TT--o-E?TX---T--?---|EB----B-B-B-?--oX--E-o-XBB----T---BM-o
o--B----TB-BX?MoX-E--o---B--B--B--EM-EM?-----E-BBB----T-|?ETB-?B--E-?-|-oo-M|--------B------?|--M------?--?--E---T--?M?T-?-----|-|B-------?-X---------M-|--M-|EE-BE---o-TM-|-B----B-X-BE--T-?--o-E--X-Bv
Mo-|MX?T--M-|--B-B--X---X-BX-?-----E-B-o-E----?TB-X--E--E?E-------E-B---?---T--B-EM|-EX-|XoM-?E-EB?--B-----B-M-----|-|-o---B-ET-T?-EB|B---?EX-X-EBT-XE-M-X|M--B--M-----?-X---o-B-|--E-----?X-?o----M|-BB
MXE-X---M?----|-?TB-E--|E-B----?-MB-TTX--|X-BB-??XT||--T---T--E---B-T?----|-|---XM----MB---|--?--T--|----E---ToX---X----XB|M-T----E?---B-TB---T-----?||M-?--BM-?--o---X---|---------|--X---?-ET?BM-o---T
B?---?M?X|----M-ET|BMM----MMEMT---?--X-oBX--X-X-B----?|-E||T-----XE--XM--|T--?EBB?X--M|E-?-X--o-----BBBT||?TMME?---||---?|-----B--X-B------BX--B-BB----TBBBX-?-?-X--X?M-----|MB---E|EBE--M--|X--E-E-B|-E
X-?B|-----B-M-M-B-----X-o|-M?-M?----oX-B-|?-B-----|X---EM--XBo-TEBBB-?|-TM-----T-?--|-B--BB-|----M|B-B-o-?-----oMo?E--X---XEM-E--||XB-XB--?o?-?----MEX-M||---TBT---X-X-Bo---|---E---BEB-B-?B--|TE-BBM-TM
------BM---BMEB-B-----T--M-BB-E----M-T-|???-?-------E-ME---M--|B----MB-X--T-Bo-X--E--MM|B|---M-?X|T-?T-X-oE---T|-?TXBBo-T-BX-E----?M--TTB--?--?-E--o-E-?M--B|----T-??|---|T-|BME-?-E?---MBBBE-T--E-----T
o--E-?T|-TX--?--M?--ToB-M-BB-M--|-EE-TT-------TTM---|---Bo---o-----X----T-X-oX--B---?---T---------|-E-T?-E?TB-XB--B?-EE|------M----XE-T------T-M--BT---BM-?EX---XM----X-XE-BB---T-TX--B--|-?--?-BB----TT
m-o|o---B-----MX--X-B-X--T-|------BM-?-M-X-XMB?X--E--T?B--MTT-MBE-X----?-B?-EE-----MMM|-----|----E----X-|-ETM-o--|---B-M------X?ET--|--B-TM-|-B---E-B----M-M-----MM--T----|--E----MT----E--?--TB--TB-MXT
Xoo-ooo---o-o-ooooo----o--o-ooo-o-o-ooo---ooo-o--oo-o-o-o---oo-o-oooo--oo--oo-ooo-o--oooo-oo-oo-ooo-o--oooooo-o-o-o---o-o-ooooo-ooo-oooo-oo---o--oooo-oo--o---o-o--ooo---oo-oooooo-o----oo-----o----oo-X
