|X?EoEToo---B----?-----X---Moo-X-----XXM-?-M-XM----TM---T?-Too-T---E--EoX-B?o|T|----E--|E-o---|-T|M-X--T?--Eo-|X-XTT-M-|--o--------|---E?--B--B-M-T-T?M--???B|-oEM---?BT-T---||-o------?o-M--EE--------E
X-B--B--X--B-|BMB-|T-?B-?|------B-|E-|--B---B|--E-?-?-?------B-|B?---T--ME--B?-|-MB|EMBBX?-B--TT-|M-|-|B-----B|---B--B-Bo-------B-----|BBT------X?B----?EE-B-XE-T----B-T--T-|--|-?--E-M-M----E-------E-B
E?--M|---?-|-?------M?---XM|--B-------|-E----EM--BTTB--B---TE---E-XMEX-o?B-------B--BXEX----MT-B--BT----o-T---o-TEX--M-To---M--T|BXXE?---T?-B-E------TTE-|-?-----E--TX-||XEB----E--|EB---E---B-T---|--MX
M|---T-B-|---|?----M?E--B|-BB--XoE--?--|M-------MMB--E---E-E-?-Eo---T-B?|X--------BM|---B-B-------T|----B-E---Eo---?--ET?M------E--o-B--o----|--|-To-B-E-B-E-T--M-T|B-?--B--o----|M---Bo-?B--B-|MB-----E
B-o-XM--B-?M-X||E-E------?E---?------B---B|--E-X-T-B--?|--|-B-|?T-T--T-TMo-M-X?E-?---B--Bo--o-?-B-TX--??-----M-MBo?--M-BEoTXX-B--o---X-B--E-|-----------T-|?EB-M----B-B--MB?|--?-?B-MB-?--M-----o--B---|
T---MBB--?--|-T---M---B--o-XT----B|T--|XE------E----|BM----o-o-B-E||E---E-B-----E?---EBE--B--B-M?B|--MBET---X---MEB-?--TT|-?-----X-|-?TEB-----X-E-E-----?--BB|-------|BM-?|--M----MBT-|E--?E-----X-EB-X|
?-E----|------TXM----E-|-E-----E----|--TEB--TT|--|-?--M|-|-?----MT----BE----X-o?EE---o|MM-E--TT|-o-M||?-----MXMB-TBM-|-o--MM--|----EXXTX--M--|M-?TM?---BoB|B-|o--|---|T-B?--B-T|M-E-B-BT---?-B-M---?M--T
?--T---E--B-|BTX--|?----E-|M?EE-MM--EM-|---||----BBB?B----BMMT-----B----|--B-Mo?ET--?-?Bo-----oB?-X-B--B-||E----E-BT-?---X-?--|--EBM-T-M-T-T--E-E----E--?-|---||---B-?----M----------|-E-?M----BM-ooX?-v
|-||---?-EoBB----oT------------E-------T-------o-oEB-|---ETM-|---|-?----BTT-M?-T|---B|-?--M--MT-------Bo-T|---MEo-o--|B--?-?--MM-M-X--|TBM-T--o-----B-B|---|---BT--|-TT-?B--Eo-----?T-X-B?--oBB--------?
TBXT--EE-X-?---E-----B-E?-|B--B--E-B-TM-B?----E-X-BX?-------MX|X-B|-|T|T--|-T-?-|oX----T--BB?-E-X---M-?To--|----B--BT---------?-MB----??-EX-XMoEE-B--M--EB--B---T?----E--oM|X--T--M|TE---T------|-|M?--T
?o-?-XB--T?--B----?-M-----|EMTTE-T--E---?---|----||--------o---?-XoT-B--T--|T--B|BM-o-M--BM-----B--M|M---X---BMo--o|-?X--B|MB----?-|B---MT--ME--|--------BoT--B--M-----BT--?-B------B-M---?||o----?-T--M
E--T---------B--M----?----XTBE?-M-B-E---?-|E-X------E-E?M?BBB-BXT----M----|--E?E-|EE|-------|-------|-|-X---X----BT-To-X-EM---?T|o----|T-?--------|----|----M?---?---o------X--|B-BT-T----oB-TEoBEX--E-?
|?---?-BT?-B|B--EE-M--T--M--B-TE-------?M---TM--E---BE|?BBT--TT---?X--B||-?-|-EB-M---?----BX-M---E--BBB-B--|o--o-|B--T-T--|-T--|-??B-|-||-E--?---|?----o?X-EX-TB------?B-T--X---TE---BE---B---?M-B----B|
T--------oT-?----E||--X-|-X-BTB--MB|--M--------X-oT-?E?Bo-?---?o-|?-o--X--To--X|--Eo-XB---|B---|--?-BEEM-?---o-|---?E---B--T-----B--ETT-----------E----T-||---|-----B|----------------T---B--BE-B-?MX--?
m--M----B----B--------BM--|-||o--B-E--E-M---?|B-BMT--B-|T--E-T---X-----?B-M----E-BB-----B-----|BXMB-|---EoEX--?XE--TBBE-X|o-X?-BT-?-EBM---T--TE?-B--oM-----E-?E--|----|--oBT--BT---T--B-B-|-T-----M---|E
XX-XXXXX--X-XX----X--XX--XXXX-XXXX--------X--X-XXX-----X----X---XX---X-----XX-X-X---X-X-X--X---XXX-X-X-X-XX-XXX-XX--X-XXX-XX---X----X--X-XX-XXX-X-XXX-X-XXX--XXX--XXX-X----X------XXXXX----X--X--XXXXX-X
