?----?oBX-?o--E?E--o--EE-EM-T-|--?-----X|-|------T-M--T|-------o-----B-MB----oB---?oBE-o----oEBX-B--|EX---|--------|X-X--?---X----E-B-T-M-B-o--?---To---M-B-T|-E-B-oo---BX|--|-?--B---TT----T--?-----T-T
T---|?-o-E?-----?---X-M--?----?-Mo?TB---??----XBX?-|-|-?|------?XTE-?-E-o---o---B|-X-?X-||-o-o-E-B---|----BE----?---|o|--X|-B---B--?--E--------ToXM--T---o----|M--ToT|--o-MXE---|B|T--o----X------To-|-|
??-T--|X--M----?----B---?-B-TX--?B--X--M---E-?--B-X-o---X--Bo-TX--oE|--|XT--EX?-o--|-XX-?|---|---o-X-TB--T--B--B----BBE---|TEX-T-X|-X-?--T------T-XXE-----?MT--EoMX-----Eo-----X----B|-----MM||----M-|B|
|?-XBoX--o--|B-MEE|E-BM-T|o-ETTX--o-BM--X-MXB--o-M-------B------o---EE-----TE-|Eo-o-X---o|---M-B----MM--E----E?|-|--|--X?-XE?---|----oB--o----B--oT?T--|-E-B??-oBE-TMo-Mo--|-MET--BX---?---|MM?-T---?-Xo
T-EX--M----|-EME----EM---BB--E-??--T-TE--X-X--B--|--o-M-T-|MM---XM?|-X---ETT--E|-o--XE--M--ETo-Mo?-EoM?-MT-M-|---Eo---EMTE--XX----Bo--EMB-TX-M|-BBX?--oTME|--BE-|--|---E|T---|-XB-o-o-E--XBX-TE---X|-o-B
T---T-o---B--|-EB--oo-|X---?--X-T?---|-?MM--?B--oT----B|-E-|-X|TX?o------B--o-M---BEM--E--E|T-|---To--EE---XX|--B--|-|-o-----T----o-E--M|--?X---M--X-X-B---EMBM-o-B--X--M-o--BM-M?--B---X-BT-o-----T||-?
Mo-X----|-B----?----M-E-----|?---?-o----BTX-X|---E--?M-ET--|---BM--EBE-?--T|BX?B--EEE??-B?---X|-E----X-?X--|BB--M-MBM-TT-T---oE---M---XB-|------?-------T?|o-EM-----Eo---E------|XET--T-BE-?-E-T--BoXM-?
XMB-XE?ME-|M-?--?--T-|--?---E--??---o-oB-o-X----M?---o--|?-XB-M-M-X--?o|EB|?-|B-T|-TX----XT-XXM|BE---?----XB|?EX|-TX?--XEXBo------?-B?-M--??oo----XMXBTo|?-B--?-oo---X??X?-----B-o---M?-o----o-----|---v
E-------X-BBX-ToMX--o-XoTT-----M-M-?X---T-E?----MB-X-T--T|?---?-----o----X------X-T--o---X---MX--T?---?o---|-----XB--XBET---|M-----oE---|?-o-M---M--E--o---EMX-M?TX-|-----|-o--o-o?-------|--M?--XMT?-M|
-|---o----XT?-T-o-|B-To-B?oM|--B-?----MT|?-B-o--X?-B?---TE--|To-Mo--BX--M?-B|----X-|-B--E-|o---X----|TE-----M-|-EXX---MB-B---B?M--EoT--M--M|X|E--X---|o---B|M---T--B?X--MTo-X--?X--B--X-|X-Eo---B-TMoB|E
?-----|E-Bo-Mo-X-|-M-T-----?-|B-?----|-EoX-?-ET-B-?oE|MTX---M------?M---?--|--?----o|---X---X-Bo--M?|M--|-E|?X---X--|----|XB|---|----M---T--M-E??-B-o-E--|---T---E--EX-|-T-T----o---XTX-----XX--EBo-XX-T
-M--M|--?-X--E|-?-T-Xo-X-B---EEB---T-X---|-------o---|-EMTB-BM--X--BX-o---o---------EEo-TT------|--o-BT--B-BXoX-MEE--M-o---XB-|o-XEo-T-TM---Mo---E--o-|--E-Eo--?-|X-M----?o--Mo-B-T--B--?--B--?-------Mo
EE-M-M-M|o-B?---o|E--|Eo-|o-?---MTo-----T-?--T-----ME-T-M?o-BMX-M-----T-B|-T?-X?------o--||--o-B--|?-Eo-E|--EEET--E|T--BM?--X-----o-?------T?-|?--M-BMX-E-B---BE?---XT-T|MEX------|B-?o-X--oB-|To-X--X-X
-----T--T-ooM?-TM--o-MXo-T--T-EBX--o-BE--oo|--|--o--M-|XXXM-M--||------|-?-M--T-T--B-?BoM?o-TE-|-o-B-E-o|EX-o----B-o-T----Eo|E-XEoB--ET--M--o---E?---B--B--E---o-o?|o-X----oo--E---?--T-TT----B|?---T---
mX-B?-------B-M--B-T-------B---TM-XBoX---X------------?o-T-?T----TTB--XBEo-oB-Bo-?X---TX----o---?B---T---|B----T?X----o-o--E|X----X-T-|M---M---M-?E-|TTM--E|X--B--------EXB?MM--oT--------M-X-------|--M
XXXXXXXXXXXXXXXXXXXXXXXXXXXXXXXXXXXXXXXXXXXXXXXXXXXXXXXXXXXXXXXXXXXXXXXXXXXXXXXXXXXXXXXXXXXXXXXXXXXXXXXXXXXXXXXXXXXXXXXXXXXXXXXXXXXXXXXXXXXXXXXXXXXXXXXXXXXXXXXXXXXXXXXXXXXXXXXXXXXXXXXXXXXXXXXXXXXXXXXX
