?T-B-E|X?-|?M--MBM---X?M------E--?X-T--Bo------T--||--B-X--??oB|??B--X---B---------X---B--|oE---EEE-E--M--?--o?E-MXE---TM--|-M-MMM--T--o-?----X--E-M-|--T-X-MB----M-M--X-X--|T-??o--o-M---?---?B-BM--??E
-|-----MMo-?---BXM--T--|oBB--T?-T---BX--|MMoT??XTT---|-T-B---X--X------X-TBX-E--X--BE|M----T?-XX--M-EBoBoX-ToX--?-E-?o?o-B-X---??--------E?-M--E---o---oMB------E-T|B--BTTB-BT?Moo---X--X----?oX-E?--oEB
XM--o-EB---XM-X-?-X---B----T?-o----o|TE------|--|B-------Bo--o?-|--X--?o|-?T--|-MM-----|----|--?o-B----oT-T?To------?---?--|X-TX|-E---?-?B|-E-X--B-BoX----?TX---B----MEB--?-T-B??M-o----------BX-EX?B-X?
-E----|-oE-----M-MB-X---XX|---T-M|B-oT--X--?-M--?--?-----o-T?|o-----?-T--o-?-TXT?o?oBM-B---M---B---E--------?-To------ETE--T-MX|X--B-?|X--M---BT--?-oTo--?--E--EM-M---B|T|M-B?--TB?-M----T-XXEE|-----BE|
TM-E--T-----?-EX|M--oX----------o--BBo-MT|T------?---oM-M--B-T--X---?---|-|-o-BT?---EE-T-EE--B?-o|-X|-M-B--B?-EE--o---T-?E-X---B---E--B-B-T?|-XM-E-?----E-M--o--XB-M--o|---XTB--E--M-X-----X--M--?--BX??
?||EMB|X---M--M?BEX--T-T---o--E---E-E---|-------T-||--M--|?--E--?T--o-----EMX-X-?o--o---oEXoB--T-B---o-T-T-Mo-?M?---M-Eoo-?T?-M|T--BooXB-----o-MBB-X--T-M---Mo-E-To-XXXB|--TB-?||M-------o-?o----|--MXXo
-MT--o--oT---o-B-MB----E------o-|B-M-TB---TT-TEMoB-----B-BT---o-?B-|--o-EX-X?--E--T|----------B-XX-|?|E----E?-----?X------B-TX|----E-----Moo?M---?-MEB--E---X--XMEXEM-B-M---|?--XX-B----?-MTXM-?M?|---?B
?M--B?-B-XTo---E--B--?-----o-X-ME|B-B-M----TTME----?X-B-|-M-MBET|--M-M?--BT-BM-oB---|----T??--------E-E--M-E--|T--T-XEB-oB----B--T-?---E-E-?--BM-----B-BTE---T?EoX-BM|---M?-T---M?TM-o|M-TE----?-T--ETBv
T?---EM-MT|T----BE--EME-oE--o--oM-M-T--?oX-BE?X---|-o---?-|-|?-T-XBBo|---ETE-B|-||B||ETE-X---X?-B|M-|?---B-----??BoMT|--|---M--X-TX-X-|BM--B-MMoT----XT--?TXBM--------M-E--?T-E-?-o---?T?-?-XT-M-M|o-Xoo
B?-EX-E-----X-B--o-EX?-EB-----MB------?--TXo--o---TTB|X---M-|-o?o---------B|-o-BB-|--XoB---o-B--TE-oM-o--B-T-|?|||?BB?-||-?|--M--------X|----Too-TXXBXMT-B-B-??-o-ET--MT--B--X-T-E?-|B--B--B-?TB-X---?BE
M?--|-BB--BT-E--T-XM-o-E?-------oTo|-X--E--oM|B-XX?T--T?--|-T----T-o------E---MM?--o-----?---?-E--M?EME|X-B---|Xo|?XT--|---B-EMo--MB--?-E?-----E---E-EMT--o-oT?--EBo-MB--E-E?|o-?|--|---B?B-TBX----TT--?
oX---X|BT-BT|-----B?-?-||-B--X--M---|--M---X?-M?E-?-EM-M-------X---E-T--X-------?--?---|-------B-XM?--?T----M-Bo---|?-M?-TB---MTM-|-TMTXo--T-B|T-E-------M---M---T-M-?X----oo--------E?M|---?oT|o-BB?MTM
?--METT-?-E-EM?--XM---X--ooE--MMT|Mo-oX---X----o--X------|-X-BB-MEB--?------X??TE-TE-B?|?|----T-Mo?---T----o---|E---o|oXB-X-E-T-M-----BMB-----|o---o--ToTM--|-B--Mo-ME-|M-B-T?--BBoE-|-TM-XBX-o-E-----Bo
oX-----BE??-ET--T-X----EB-|-X-E--B?--?E-||TXXoT----oBBT-T?-o-----TT--oo---E-XT--TX?--?Xo-T-B-E-?E---MM---BT||-M-o|M-MM--o--?MXX---X-M-----X-|-M|---TM--?XB-|-X-T--BEM-?X----X---XB--M----|T-B-X-------BE
m--X-E--X---E|o|-B-----T-?-X-X|----?EX--X-M---M--X-X-E--X---?BB--||-?-X|----B?E-E-M-M-E----BMX-MM----M----B-E-|M-MBE---MX----oo?--EE-EBM-M---o--E?o?B----B---X?-o---M-?|ME?-TTE?-ooT-X----X||---TEB-o-TT
XXXXXXXXXXXXXXXXXXXXXXXXXXXXXXXXXXXXXXXXXXXXXXXXXXXXXXXXXXXXXXXXXXXXXXXXXXXXXXXXXXXXXXXXXXXXXXXXXXXXXXXXXXXXXXXXXXXXXXXXXXXXXXXXXXXXXXXXXXXXXXXXXXXXXXXXXXXXXXXXXXXXXXXXXXXXXXXXXXXXXXXXXXXXXXXXXXXXXXXX
