?-oT--|-X---|M----M|X?--Eo?|---o--|-M?--|T|X--E-|--M--M?--|---?-|E|E-XBXB-|?-B---|TBM---Eo|------|--Bo-----X--XB-TB--?-B--|----oM-oTX-?-----E---------o-B|?oXo---o--T-T----ME|--o|--MT--|XTM-----T|-ooBM
|?--X----TB?-|-EB--T--T--T-B-E-o-E-o------T-E---o|--|---BB---?T--X--X-----T-M--o|-XXoX----oE-BME------EET-EM-?T--E|T--XM--B---M|--X-?X--E-|-------|TX-XB-?MX?B--E---B-M--o?-||??-T-||--BT-B-E?--------?o
o|--M--X-XX-B--EX--?---?-M-E--BM--------T-----B-oBXE----o?T-------EX---------M--o--?---o-||B-MToM---|-T-o-TB-|---E--XB--?|-MX----|--?------B-T--T--TT--oE----METE-?---Bo-T----X---TBX?-||MB-o--oM----oBo
?|M-TE--oTX--M|-??oT-To---T-M---TTTMBT-------Boo-|M-?-Eo--|--M---E--?-|-?B----EMBX----E----TE--XT----?--oE---|-T----X---?M--??o----M-??MB-oToB---|-|--|-?----To----------T---|E-M--M|?----oT--|M?--|-|-T
?-----M-X-----oB-B--BXT--|B?|B-E-Boo-|-?-----E-?E--X-?--oB?oE-BoBBXXM-B--?-?o?|B?E-EoE--E-X---T---|?--oTE|X----M-----X--XM-EE|-|-T-?--?---B-T-T---B---BB-MToo---T-MEE|--|---oM---|EE|-EBMB-B----------|o
B-M---M---?-TM----|EM-B----T-MXB?M---X-T?--|B-??-o-------o-----------M-o-Eo-o-----o|-------E-MMB-E-o--TEMX|--o-|-o----TX---B----|--E-T-------E--B-Bo-----MM-X--|X-|-M-----BM?ETEo---MT----TM-TXB-|XXEo-|
ET-M---TE|X??o|--?TTX|--??XM--?|-T-EBB--B--MT------M|-EB-M-B-T----B-o|-Mo--oM--B-----M-XM--|---T?-?-??B--M---o-?-M---T|---MB---X---T-?-|oET-------o-o?X-EXB--|-EX----M---X-------XTET--?M----|BB--|Mo-|E
??-X----X-ToE--------MT-BB-oM---|-??-T-X|T--B-XMT--|--|oE?TX--BME-----M-----X-------|?-||-BM----X--XEE-X?BXB--|B-?---X|-B--|o-oB-XX-T-?|?X----oo--?--B-?-|--EB---X--XE------|B--BB?o----X-E-o?M-E|E|T--v
E-M----B?oTM-o--Xo|o-|---oB--------o-TX----EoE--E-B--B|--E-?Eo--BE---EB-M-o-X--X-ET-|-X--E--?ME-|o--o-X-XT-TE---E---------?---M|B----BE-E----E-?M?TT--TX----TM|--T-TB--||Bo-----M------MMTT-?-------B-XE
?---T?----?---Mo-o-o-M|E-B-oM-XM-o||--X---Mo---oX-X--X---E?----|B-|T-T----T?--M-X---M--M--E-Bo-|--B?----|---?--EBE--X-----M-|--X|--B-o??-??B---?E----|-|M--MMX-----MB--o--|o---X?-M-?---T|-o------o---ET
EX-o?ME--T-|------E-T--?---?XB---?---|Moo-Bo-M---------B-X-T----|--B-X--Xo-Eo---|-B----?---B-EB?-----B-?-o--?--?T-MM-E-M----X|-???-E?|--o-|--?-?-X?B------ME-E?-?XTM-?---EMM-X--T----T---T-Mo--M---|---?
oX-?-X-|M--E-----------------?X--|--|X--EM-|MX----TB-|---X-X|--BX--oEXXM----EoToMo-----MB-?oX--MMX--o??E---E-oTB-----|-TB-TM|E---BTM---------?-M--?X|X--M-----M---?--B----o-------XX---E-|o-ooB|MM--?--B
|M---?-|--X--?--E?E-?E|--M|-------X-----o-|----X?-X----|X-E--M-|----|X--??T----X-M--oBE---T-o---?---o-XMT--|----X?-----T---|--E----|--M?-o---T---X--EX----E-o-------?--|o-o-|-Bo---?EoE--B----M-o?M--M-|
X---EE-----ooEEXEX-MM?E?Eoo-|-|-----MXM?-B---|------?-o|?----|E--X-o-XX|-|---TTT--X----BMB-M-----B-B-?|-?-------X-|X-o-T-------?--X-|---BT-T-?------M-?-XEM?-BT-|EB-|----o--|--BoM------ETB?|----ooB---E
m-T--MM--o--ME-E-T|-X-B---X-MoB----M-----TX----T??--E---?--?M----?---||-----MX-o----|o-----B|----o--o-|?B-o-oM-E--o-|---MT-XEMXo?-Bo-o--o---MT-oE?X?-E---XX---B?--E------EM-oBM-o?---MB|E-?----M-MB-E?TX
XXXXXXXXXXXXXXXXXXXXXXXXXXXXXXXXXXXXXXXXXXXXXXXXXXXXXXXXXXXXXXXXXXXXXXXXXXXXXXXXXXXXXXXXXXXXXXXXXXXXXXXXXXXXXXXXXXXXXXXXXXXXXXXXXXXXXXXXXXXXXXXXXXXXXXXXXXXXXXXXXXXXXXXXXXXXXXXXXXXXXXXXXXXXXXXXXXXXXXXX
