|---B-T-oM-BT--TM|oE---T?-T|----?-o--o------B|B-?BX-B-X-ET---ME----X-M-MXE----BT-X-To--?---|-X-T-B----XB-M----T---BT-B-X----X--E-T--|T-T-o-M-B-----EBoBTMo-ME----T--------EE---M-|-MB-o---XB-E-?-MB-E--T
TBXo|--E--o---------TB?--M-|-T-------T------TE-T-T--o-ME---M---|T------|---T-TMX----XE-----BE?ME|BB-M---X-----EB-X|M--oo?|B----M--B--MB-EB---|E--XBM--MX-M---BB--B-TT--|-|-B?--?-B--B|?XT--------M?E-B-o
|--M---E-TE--B---?-BB----o-BB----|-X?--|--|---T----B-X-o---B--o-EM--E---?-BM-?-|-BT-----|--E-?|-?---E---BEBX-E-T-M??-||------M-M-----B?--BEB-BBTE-?--X----|X--E-B---B---B-E-B-oT--|-------MT-T|--------?
T-?X?----|E?-----BB----BB-|E-o---M-|-|--?|--BEE-MM--|E--TMMBEB|T---?--------E---X-M|-M-X--BX--|B----T---?|-M-E-?B-MX------To-T--TEo-BTM----?-------B-B-EMB--B-?--E---X|-M-B-o--B?-|--MBE--?E--------MT-o
T---To---?E--TEo-B--?o--E|-M|M--B--B-?o-X--?B?------Xo---|M---T-T--BB-TE------B-E--B---X|------B--MM------B-BM|--EE-E-|B------B|---T---B-----M-X---?T--M---M------B--|-T----TEB-X?--B-BB-|--X-M-EBE?-BBX
--|---o-------M|--EB-?--XEBM?--|-?-B---TE-EoT?EM------XEEX-o-BE---------B-------T------------T|B-|-|oE?|----B-?----EB---E??--TT---B--T---BB|---T-BB-To|--|--------|BT---EMoM-BT---B---o|o--To--XM---o--X
E-|M?BB--TB?---?M-|--T-B-?XT-----B?|B--------TX-M-B--------o-EMM-?------oEM--?-T--BM?EMBEBE--TTEM------TTTX------o------T-----X----T-B-?-X---E|E----?--?-E---M-MT---|-T|---XXE-?E----?TB|T---oB--T?B--TE
M-----?M--MEoB-?BT-M-BBE----?--M-TT-E-----?----|-MEM?----o-----?o---B-E---|M---B|-----o------|B--??-E-oE--MMX--|-----||-B-M-B---|-|o--EB-T-T-X--?E?o|-----X----EX|------|--M-BE-?-o---B-T--|MB--o--B--Xv
o---------|----B---B|o----XB?X-ET---EB---?--M--o-|---------?-B|-B-------|B--XoToMXo---------?B|||-Boo-|--|-B-MT||-oM-TB--?----B-|E--TB|----B-----M?-E--------E-?-T-||--------B---?---M-M---X-XoE---M-B?o
o-----M-|--EB-M-X----------M-----T--TT|X--||?--??ET-----B?E---E|---BM?|----E?-|-o----?-?-M?-B--TTE------E--E----B--?-||----o------E--BT----------T-------T-|--B?B----o-||-ETo---B-B--XEE------|-E?-B|M-|
T|-E-?--E?E----X|----B-------?-X---BB|-T-----B-B--?----E--o---TX--?-|T--o---M-M---|---B--T?XB----E-E--|---|-B----E----?B----M----B---o-----|-M--B?--?--o-E?-B-|M?-------EX--------T?---X?B---|----T-MT-T
X-?--o--T--T-B-oEBE?---o--|T---?-BBB--B--M-|-?--B---B-B-B--|---?|--T---B-B-o---T-EB-ME|||?o--?-EE--T---X-|--MX-T-|BB?-?--X-M|B---B--?--E--BMX-B--|-B--M--o|---??-------B|-B--?--T-M----B|T|TB-------?M-T
X---M-Mo---B|-o--|--TX----M--X-TX-B-?T?EMT---E?EoT?E---oM-oB--E--EB--X-M--M-T-B-M?o-|--?--?-----BT-|?---?-|-T---B-B-MB-E---E--X---?---EEX|XM----BB?X?--oT--T--BTMEB---E-----M-B?ET---?--|XB--M-B--X-T-BB
|-----?-B-|-?--B-??M---T----M--M--E--?T--X?E--MEB-|||-B-------|BB|XBT-------B-T----?EM-E---E-------BM-E----T---M--BB?-|-----M---|-------|T----B--|To--M---Eo--BX--------B-M----?-MXX?EE--B--B?-----?-BB?
mMXX-|BE--MME---M?---XT-XB-ETTo---|---B----T-X--|BT-E?MB-X-E-B-----M-----?B-----oTT---|?----ToE-T-?--B|--EX--o-B-B--??-T-EB----?----EM??T-T-M|-E-X-EE-|T---?-B---?M?MTBE--T-B---Bo-T|M--E-?EM-?----o--BT
X---X-X-----XXX---X-X--XX---X-XX-X-XXXX-XXX-X--X-XX-----XXX----X----XXXXX-XXXXX--XX-X--XX-XX-X----XXXX-XX--X--X---X-----XX--XX------X-X--X-XXXXXXXX---XX--XXX-XXXXXX-----XX--XX-X---XXX-XX-X-X-XXX-XX-XX
