o?E-?B-?-XX---|B-|X--?--?-----|X--X--EX----BT-|BM|EB---o-T---|M-|M-T-EM-M----oT|-MX-----M--T-?o-E---oX--oX---X---o-o-oBM--T-X-EEo-|---|?M?----X---MMX-o--?----o??TEMT--o-XBXB|--------T-B-B|B|-----oX-ET
ETB-B---XB-X|-T--|---XTo-T--X--T--B-BE----M----?o-o--MT---o--?--o---T|---M-|-E--B----ME?--T--oBX-------|-B-B---?T---T|-X--X------E----E-XE--o|X-T--|XETM-E-E---M-E-TB|-o|-B-o-?X--?--|-o-----o|-X-E-?oM|
B?|-B--BM--EM----o---M-----E----MB-X||--T|-T-Bo--T--MM----ET-M-XM--M-oX|T?EM--BB-----M?B-X-T-X-----|BB--E--|BT----oEM---?T---o-T-B-----X-M---T|--Bo?-?XX-XX-X--B--?-MT--B-M--E----?-M----?B-o-?--EM--|?|
ETT?|---T-|T|o-B-E?-----|-Eo-?|-|-----oE??---|--T--E---T---E--X-----oo---BME--X-?--M-B-B--oE|-TTE---|-?---M-EM-E-|T---TM-B?oE---o-MT-|-------X---|B--B-----B-o-M|--X---XE----B----T?--|-----Mo------?-B-
BE-----E-?--M-T-XE--oB--T|-o----T-|E-X|oX|XB-B--B-B--B---|?T-----M-M------?T?-Eo---T|o-------M--oT--XE------|E?|--|---B-|-oMoM--B-BMM----E|---oBo----X---B?----EE--M-|-TX---oX-XEoB-XE-XX----BBT-E--?-?|
|?X-|?B??X--T-?-XE--??-oEBX-E|-?-??--B----MT-T--M---?-T-----T?--T---XM-MB-E-?Bo?--------?M-o---X----?E?B--BTX-|--o--|XX-------X----|o-T-XB|-o-X-------oXBM-|---M--|-|M----T---B-T---?-------T-M-E--E--XT
-M---?X-XTE--?---|---TX-----X-oT|-EXE-----o--T-o||---BT-||-T--?|-o-|--o-?--EM------T?-XXo-E?-?Xo------|--M-?-o-oB-E-M--o-BXBBE-|MT-------|-oB-oX-|?-BX---B--|E---|-o--X--?B|oo----X?---?E--T-BX-------BT
MB-o?E---M--BoX-X-o-M-TEET--|---BMM-o?----B-E-T--T?o?---|---|M-?--TMoMM--B--?X----X||-|--X--B-T-|-|-|EM-E|----ET-oB--ME---?-----------|T--B-XMXX|--?-o--B--?-BT?E-?--T-oE--?-M---E-BTXEX---XXT-M||--E-Bv
EX|---o----M|----EXX---?|--T-oM-E---??M-?M---X-------ET?---|-?X-M|-----T-|-TM--E-|-?-oM-|----M--T?---E--|Xo--------B?--ETT-T-?----EXo--|Bo-----T---E-Xoo----BM--MT--?--EE--oT--|o-X-|--M-TEEM--B-MB-o-Bo
----E----|-oX--?oX--?M-----?X-|--B--o-E-X-T-------T------Xo-BTX-MX-EETB-----M---o--Bo-----------o-B--B--B|BBXT--|M-oB--o?|-?-E----|-M--o-TB-----o-||-TB------XTB|-X----|--X---T?---|EM--?-MX--|-B|---X??
-X-BoE-MM--X-T--TE?--MX-?--X----X--o----B-------X-E|-M-E?---X--M-------------XE-o-----X----T-----M--TMXM---o--?---------M--BXT---M-E?-T--o--?T-T-oE|B----?BXB-|---?o-?---M?XoB--oM|ET-M-E|o-T-T-?|-|--Eo
TM-B-?---B----E-X-|-X--oo|-oMB-ETT-ETT-ET---|X--E--X-o--TT-|XM--?X-T?o-|----Xo?---?M|---|XE-o-o-oo----X-|-E?T--BB-B?B-----M-----XX--?-----?E---BB----M----M----X--T-EX--T--T?--MX---E---oM--X---?E----X?
|---X--M-o-o---M--|-BT--T------|----B-XE??------E--X-ETX|X|----T-E--------o?-X-?---M--B?-EE-EBT----B---E----?T----E----B-----M?-ET---?-|-----|M|E---T-|XXM-X-|--Bo---X?o--BXE-X--X|M------X---?-?-T--EBE
B|M-oo-E--E-o?X---B--|-|BT----EMX|T--?--o--E-|||Mo|o---TX--o-M--T?T|E--X-XM-E--XMo---MX??M-------X--|---?-X-?B?--E-----|----B-MM-|MX--E---o--|-E--o-B|--BX-------???M--TBoE|-TE|M---XT---||--T-----TT-??
mB|-?XBM-X--XX-?--?XX-M-?----To---|---?--XM-BMTM?--B--X|oB-?--E-----X-Bo----M-|-oT---M|---|--TB?E--X--?BM?oM-o----B--E-B-T---|X?--X--E-o-?-MT|--B--|--|M?---B-?M|ToT|XM-Xo-T?Bo-B-?|---MM-|oB--M?---?--o
XXXXXXXXXXXXXXXXXXXXXXXXXXXXXXXXXXXXXXXXXXXXXXXXXXXXXXXXXXXXXXXXXXXXXXXXXXXXXXXXXXXXXXXXXXXXXXXXXXXXXXXXXXXXXXXXXXXXXXXXXXXXXXXXXXXXXXXXXXXXXXXXXXXXXXXXXXXXXXXXXXXXXXXXXXXXXXXXXXXXXXXXXXXXXXXXXXXXXXXX
