E-------E--o-|MBE-|-B--T---E-X---E-----T-|B--B--XT-B-?BB-?--??----EoE-X-?-|o-X-E-T--------o|--B-|--M----Eo----X-E-BX----B-T--|T-T|E-Mo-T|oT??B--?---------?--o-o--?-B-----?T|-TMB---B?o---T-?-?|EE--Bo--
oB-|-TMM-TBB?---TB---BME--?X--BT---BMX---?M?|--M-BET-X-XB-M-||-M----T---|---|-X--------T-XE-M|---B?|E|oB|-T|EMo-B-M-To---||-X--Xo--To--?-MEBM--o-?BB-B-T--T-BM|T---B-----?M?--XTM--oB---E--BMT-?TX-X-T-T
|--|E-MM-?--E--E-?MXM-E--E---B-?-B--BEMEE-E-M-|-XB-oE-oT---oT--?X--T-|T---?--T-----T-----------MX-B--|?-?-M-B---E--B?-E-TE----o|------o?X---|o--|------B---M--MM---|--?--X--M-----MM-TBE?B---?---E----M|
M?---BT----EEo--?---?---EMB--?B|--E---TM--?-E-|----T--XE-E-TMM---XE?EB--M---XM-?T----X-?TE---|-|-BoX?TT----XM---X--E---T--M--M----T-E-E-X-|-E?BE-----|EXE--X----T-oT----?M---|-E------T-ETT-BE-M-----TM?
EXE-XM-BE--M--------o-EE-----T----?----XBMB-??-X?X-TMB--B------?--MB----|--o--E-B--T---?--T-TE|-oEB----BE-EB--XE-|-T-oX-|T-B-E?--BTM---|EE-|o---?--XMXE---M---B|E-------?-----ET-X--TTT-T|-?-----X--?T-B
o-|-B--E--?-o-BTMT---MT-B?---??E-?TE|-oXTT--|-TEEB--X-?M|-----BB-ET-E-B?-XBT--BM?|----B-??M-M-M?-B---T--o--X-TT|-E-oE-E---E-T?--B?--E-||--------Bo--?B------|------?B--TM--M----B--B--T-----B-B--MM--MMM
M--??-----|-|-M|B--E-X-M--E--Bo-E?X--E-B--?E----X---B-|------|B|------|----?|XBoXE--|BT---BE---EBB-||----T--?T-?----?--B--M-----M|B-XTX--MBB-?|------To-|--E-|X--X-M-BEX--B--T?|EEMo--??----X|o--B-MMB-M
EX-----T|----BTM-XT-B-|---o----|----|E?----?EX-?--o-TMT?---|B-X-XT-ET-X|?--|--E----|MB------?X-M|---T---X-?|o?ooX-T--E-E--XBMB--|B-|--EE-B-BM-------B-B-B-B--X--?-?-M-B-BM-----B-M|--?-T---XB---B---|Bov
||---X--?-MET---oE-??ET|E----T|-?-|TE?T--E-B-MB-XBTME--?M--?-?TEE-?X--?--M-XB--EXE--T-o-M---M-T?E-X--XBX?---X---BTBM-ME-?X|X?T--oT-?X|XB----B?T-ET--|B-oT-BB??oM?XMB|--E-?-M----o-M-MT------X--B------|M
X?MME-EBM--|-ME-BT---o-B--T--?----|E?-|-E--B-E?-X|B----BB--B--X------M--|-ET--------?--B-----------X|TB---oTBB--TBXB--M-o--X-?EM--X------E-X--XE|M-??X--X|---B-XT--BM|-|M?T----E--?--M-X------MM---|-M-M
?-TM--o--?-B---X|MX--EX-MX--XMT--?-?EB-?-X-MXM--|?-----X--T-?-T|M---BM?|T-B---TBT-M-||o|MB--ToE--XB-BB-BEX|-?------EM-BEM-B-XB----|M--------BT---E?T----X--B--M--B-----M-----||-?--B-TE--|X--X---M-ME-B|
oT-TB---XB--BE--M-----MB|B---ooB--T?E-?BBX------BB-M--TE-------B?B-?MX---B-B?-M-------T--MXE-EM---|EM-M?-|BE--?-TBB--?-BBX||EB-X--XBB---MX-B-------TEE--T--TB?|-TE-M-XT-BBXMB---T--------|--B---?-----XM
B-TT-T----E-X-----|-----X----------?----X?---ET---MTTE-|---EMB----XB--|M-?--M--E-|-T?--T--?B-ET-----M--XBB-?--T---B---E-E--XB--M|-----MX-B--?M-B--MT?------|----T-X-?-------o---T-------X-|------X------
T-?T------X---|TX--|---?BTX|---EX--|B-?Mo------X-B-o--|--o-XM-|-----|E--BBB-?---EMBX-M-BB|-BEBET--T-----BB-TX----?---E-----?-E|-----?-|-------|---?--XE---X-|-?----B-BEB-M--?E----B-|--o----|---MM-M---E
m--ME--E--|X-|-|---MM--E-Eo-TE---B-MM--E---|E-B-T---M---XM|----X?----X--T----MB-E-T-------EM--BB--E--B|T-ETE---|BM-------?-|----T-o|-E|BT-B-?TT-B-|X--E-----?----oTXEM------EM-B--Bo---X---T-|--ET-X--XT
Xo-o--o--o--oo-ooo-----o---oo-oooo--o---o---o--ooo-ooo--o-ooooooo-ooooo-o-oo-o--oo-ooooo-o------ooo---o--o-o--oooo---o---o---o--oooo-o-ooo------o-oo-oo--oooooo--o--oo-oo--oo------------o-oooo-o--o---X
