BX-T---TX---o-----EE--|T---M-|BEM-E-?--|XT-o---o--oM-|?o-?|-|-??B--oTT|--B--XMTX-MEBTM----E--To-------X--B-BX--X|--oMT-?|---E-XEo-----M--o-MoT-?X--M--|-ME-T-?-M-X--XTM-o-?EoM|M|----XTT---EBTX-|EE---TM
?T-TTTB---M|-||--X-E-X-E|--XBX-?---T-B-----T----EXo--oB-XTEX-Mo-?-|o--o--B--M-T|B---|---X---|?|-T------o-X---M-T-X-o-?o-TEM--E?-----?---B-----|---Too-|--|?---------E---EBEX?Bo?-EM--B|---MT-B---M------
X----|?-XM-T-|-E----T--EM-B|-----X-EET-o---X-Mo--?Mo??XT-B-o---B-XE---?--M------BTo---XB|o---M---?-?-XE--TE?oX-o---E|TT-X-?E-T?M--XB---|-?MT|M-----|EMT---B--E---T?--B-M-|-E-ETX?M|-M--?-B-B--XoT|B--B-o
BoX-?E-BEXo--T-?--oEXT-o?---o-E-||--B-oB-M--?-E-X-T--|-TXE?------oB-X----?---E---E||X--BT|BBo------|-oo--T-B--o---|---MX---EE|?o|---X-oo-o-?-E-M-?EE--XT|TX?-|E|o--|B-E--E-E-?-B-T?-oM-?-o-|-M?-o-----EX
?M----o--T-T-M-?--|TM?--o--X-Eo------E----TB-|-?X--|?Eo--MT?--E-B-MEM--?o?-B--X--M-|E--E?---BXBEMB?-M-----ET|--T--?--EoTX--E-X?--TTM--TT---M-XM--------E---T------E----?--|-M-o-X-?-E--|B|----T-B|M-|-?T
|-B---E-B-E--B-o--??-MoX--E|-?BB-E-B--|-|----B-|-M?-E---o-oE-|-----X-T-?M-o--B----|?-TB-M-?To??|---|-----o-X--B----XMT--E-oBT---ME-BX-oEXBB---BoB--?-E|-M-B----o|-|E--T-o-----E|--?--M--|-?E--o|-EM-T-|B
T?-T?Mo??--T-BE--EMoEoT-TX--?--E--o-T-?oo?--oMT-o---E-Bo-E---|-E----M--|--XB?-T------Eo|--B-M--TET-T-?-X-XE---M----?-----ooB?-|TM--?T--BE-M--?oM--|B---T?B---??B|-To?---E|?--X?E?M----MoBo?oE-|-E-X----T
B---TE----X-MT-?--ET-?EBX-------|--X--o-BX------?B|-B-|M-X--T-oB--B|-M-B---|?---|---E-XX---oT--|M|MB-o--B--E-||---?-BoE-|--To-o?To--ET-------M|-E-M----o--X?|-o------o?TX-M---T-E?-M?T-B-|o--X-T-o-BM-ov
M----Mo--X-Bo-XT-?-B-E------oX--E--oMMX------|-------B-o---M-??-|TT?-XX----MX?--ME|----?|-T---X---|-ToX-EMo--X?T?E-Eo---------X--E-?-T---o?BB-?--B|o---XX-X--T-----o--|-?-o----EXE--MM?-X-|---ET-|-o---|
|---M--oT-?B|EX?---M|?---TM-o---XT--BX-X-|-T|-T----------X?---T-------T-----M---o--E-o-?-ooM-B---X-M-?-E-----T--E--oT-X|B-|--?-|-M----?|-?E-------E-----M-M--BE-?-X-?-X--X?MB-MT-E-TB---B?-B-X--?B---EBX
XT--M?--?E---------TBM-|?-|EBo-o|TM---E----MM--?-M|o---T|-o---EX-oX--EM------E-MXE-|-B??B-?-?o-E---Mo-|o--|T?-TX-M-E?-E-MX--?-T?-|E-X--oM----E-TB-----X--XoX------BME--M-|-?------XT---X|o-XX-----X--M-T
EX-|--|-B--X-X-o--o--T---Xo-?--M?-oE---??--oo---ToT--|---B-?E----Mo-E|E----|-o-XE---M?--?oB-TT---|MM|--------T--BET-X--Mo--MBB-B-EM--M-oT---MM-TMB-|-|XX|M-E-B?-EE-|--T--MEBo-|-B---B-----TX--M--oo-EooT
|-------X?---EM--M-----o-o|-B-oM---|-|X---E--B---BB---|X---TXT--X-oB---oXo?BM?-T|-B----M---|---B---E--B-TM-----B----M------?--?|----E---BB--E-----?-?-BT-B---X||T-|-------T-o-?|----MoM-T---|---MT-oT--M
T--X------?EX--TB--T-|X-?-oM??-----o-B-MT------E--o-BoEX-T-B|M------M|?--E--X|T--o--E-|----B--oE?o-|-----EM|-X--o?-T-oM?-E|T--TXBBoMoE?--oM--X?o-----o|---E-|B-------T--|-?T-X-MB---E-B?E-X--T--Bo-EE--E
m-MBM|TXB---X-oE--?-E--B|-XBoE-BoBoM-BE-EET-BX--E--E--oEM-B--oX------|-?-E-o|?-|--|--o----M|-MX--T----X-o----------E---X-o-EBBB-?-----TX?X-------|--T-?M---?MXX--BM?-T---oTM-XM-EMMBoE---o-Eo--M-TBE-E-M
XXXXXXXXXXXXXXXXXXXXXXXXXXXXXXXXXXXXXXXXXXXXXXXXXXXXXXXXXXXXXXXXXXXXXXXXXXXXXXXXXXXXXXXXXXXXXXXXXXXXXXXXXXXXXXXXXXXXXXXXXXXXXXXXXXXXXXXXXXXXXXXXXXXXXXXXXXXXXXXXXXXXXXXXXXXXXXXXXXXXXXXXXXXXXXXXXXXXXXXX
