||-|-XB?XB?Mo--MM---E--M--|-----M-oT-B-MTB---oBM-X-Eo--o-XB-M-|-o---T--T---o-??-T-------B---oMB-TBEBX-----E-oEo---o---o----------|-?Xo-----E--o?B?X-??-BT---Xo----oM-----M-?B--|---o----T-|-X--ME-E---o-
?To-T--X-?------|?--M---|--|-?M-?M-X|----EX-------|-X|MM-MX-X|--o-X--o-E---o?E-||---E----X--o??-XMBE--XX--o-XEX-??-T---T--|---E-M--X---o---o--XMT--T----------T---X---To---M--B--o-B-T-M-E-B--??|--E--|o
XB-oTo-X--T|?EB--BE-----o-|-MT--??--|BM-M--B-XTXo-MBB------?EME-----------E?B?--E------B-B-------TMB-?-B-?-----EoM-----BM--?-B-oTB-TT-E--T-|--|---X-B-MM-o-|XX--o----M|X-E--TM-T?-X-|-T--------oB-o---Xo
BTB----E---?T?o-BXE-|?----E--ET-------M--|X-MT?M-B?o----?-o-o-B-oM----M-?------XoT-E-o-BBT-X-X---X-|B|-B-X------Mo|-BBT-Mo----EBT-M?-?E|--o?XX-?|EX----E-B?----E--E?----o?MBT-|--EX-|-?B---?EoBoB-----MM
-E-M-B-B|oXMMM?-B-X--?-oE?-?TX-o|?-----o|BXT----E-BM-----MMoM|-M--E?T--E-T-X-E---o---X-oM-?BTM--E-|-M---E-Mo--E-X?-XM?EM-X|--E--Xo-M-o---|-E--o-||-o--o-B?----o-EBM----E--o--Xo-M-X?--EMB-|-B-?|-o-?|oXT
|XE----M-M-T--X----?E---Xo--B--X-------|B-|---?-X----M----?|?MB|-E-X?---|---B------T-B----E---------ToE--||-E-T-X-Bo---EM?E-o-?T---XB--o-|BXEBT|T---|X|-o-T-----T--o----XE--?--?--?-oX-?Mo-BB?---X?|-MXB
E?----|---|-|o-TX-T-X-B-oE-T---M----o---o-TE--B-E-?-TT?--T|T-X---B-E--ooMX-T-TM--------------M-BEEoETo?B--M--E-o-----MT-E-T--?-|M--X-TB--|Moo|-M--?|---?B---XoTTo-?|--?|||B-B-EXM----T?BT?M-TM-------B-|
-MMX---E-?TE--|?--MM-T-M--?oM-----?Eo---TB-XoX--M---X---EMX-BE-EX-X-o-M--M?T|-B?--B-XX?X---XM--B-B-X---|M-o----M---o?-----B|X-------o?----?B-E?--Mo--oE--X--EEE--E-?-|-?-B--X---B-MX-T-----o--|--|----Mv
-B-T-Xo-|-EX--M-----T--oo-B---oXB---E|-X|E-MX-B---ToT--|MBBEMB-|----?-X--oBT|-|-E--o--E----M----ME-E--BT-B-M-----T-----BM----|E??ETX-?---X-----Xo-BE--T---??M--XB--E---oE?-o----o-B-MBT-oB--B----|-|--o?
XX----X-Too-|--|---M----------EB-M?M--M---M-|-----T|--BT--o-?Bo-o|X-B----E--oE|---|---MM-??--|E--?-B---XEE-Eo-?Bo-o?-X??--T---|-----|--o-X-X?-B-T---TB?--ME-|-?ETM-?--o--E--B-----BB---T-EEX-o-|TBXB|-ME
?TB--T--T-M??-M?---------B--|---M--X--E?----T-Too-X--M-T--o|EEMX-BT-EX-X-oT------E--B-?---|--X-T-|B-B--B-B---TB|-?B--o-M---oTM--MTo-T|o---oB-?B-B-|--oo?-M-BB-?-E-----?--||o|M?---X-T--X--T-E----M---T--
?MT-B---B--X--M---o-----E--E--?-----T-?--M--|-BTX?---EB-?E--XX-oM-E-TX|-|--T-X--Mo---E-X--E--|----E---B-T------BBT------o?------T-----T--BB-T--?-X|||X|----?--------M-BXEM-E|-?---MX-EE--T--o--|o--B?--X
MXEB---T-E--||B-B-T--E--o-?BB---T--E-MX--M----M---|-T?T-B--B-B-X--TBME-X-B---T---T-BT----?BB--BX-|T------T-|-M-X-B||--|--?B|MM---XE----?---o-X--E-BT-B-----oT?--------X-T|Eo-B?--Mo-E-?---X--|-M--BB-MET
-X-?X--?XE-?--X--MMMB-MB--|---B---B--T-------EM-EM-?|TMBB|XB-MMo-----|----M--|?T?--M--T--?--B?M?B?-|BM|To---TXXo-?--Bo-T-|B--|---T--M-M----E-XTo-M---?-T?--T---T---X-----------B-T?-|B--|B|--B-ooB?----?
mE-------------?-----M-|M-MXEM--?|-B-?T-|---E---X-XX-Xo?---T|---|-B|BE-?--?-|--EMoMMooBToE--T--T---o--X---MT?--E---oE--XoT--M----?-?-TTXB-BT?T-X--BoMX--BX-MXT-B-T------X?---X---EEBM-EM-----?-|-TM--|Eo
XXXXXXXXXXXXXXXXXXXXXXXXXXXXXXXXXXXXXXXXXXXXXXXXXXXXXXXXXXXXXXXXXXXXXXXXXXXXXXXXXXXXXXXXXXXXXXXXXXXXXXXXXXXXXXXXXXXXXXXXXXXXXXXXXXXXXXXXXXXXXXXXXXXXXXXXXXXXXXXXXXXXXXXXXXXXXXXXXXXXXXXXXXXXXXXXXXXXXXXX
