TE--TToM--B-X||?-|-----|oE?--MM--TBBT--BXBTE--o-E---B---BEM?-M|--E??---XX-TTT?T------E-X---B-----EBB---EX-----T|-oX--B-M--T---|?----|---M-T----B---MM--?o-E-oM-----B--BMM---M|--MM?|T-B-M--BB-----M--MET
Eo---ToEBM--X--|--TB--M-oTT-------BBM|-B----M----M--oX-X---|-oBMMBX--MM-o?-T-T-EM-MBE--E-X|T-B-TBBo--|?-B---?-M--T--?---EE-X?T----|EEo-M-o--------BMo-|MX|-B-E||--B---X|---B--TT-To|EE--EB--M-BE------T|
XX-MEEMXo??-----B-?X----BM?EX|M-X------B-?-|-o--M-----ME--T---T|?--TX-To----T-----B-oBB--B----B---M-o?----o|oT---XB-----X?--|o----XT-|-?o-?---X---E--oE--X--|--?M-?----|BM--E-|XBT----B--XX--o--MX--XB|M
E?-T-oM--oX--o--?oB--Mo----MoM|-TT--T----------M----XM-B?---M-TB-BXB-T---------o-|-BB-T-EX?--?--MBB?--E|?--oEToToo|-X--BMTTEMB--T---EBTB-o-MM--T-o---X----Xo?-------?-ME--T---E|?|----B-B-??-X--T-MX||?-
XXT-X-----MM-M--?B-XXB--E--T--|-TBXE--B--?--oE-B-TTT?E-E|-M-|-|-EM--To-oo-B?--|-|o--MTB---o?---TBTB-E---B----?TX--M-EX-X?-T--M--Mo------B-?-----o?|oBo-o--?B---M----M--XB-ME-TT-|-B-o-?--------B-MTo|-ET
oXB|--|--BT---E-Boo----T--XMEM--M-?|B|X|---|-?-X-TX--T---------X-|oo----E|-?---BB?EMB--B-E-------M-|---o--o?-B--E-B--B-?|XoE|-E-|---XE--?--T--ETTB?M------T----o---E--|T-?-?--T-E----BE--B--oMo---T-X-E|
o|T----?-X---M|--M--|TTXX------o|EMT------?MoB-?o--|----oBBE---|----o-E-ET-----ME---X--M----o--MM?E--|XTo?EM|--MB---T--M----B-BTMTBX--|BB|-------------TTM-oX-----B--E|X-oBM-----EX--o----o|-----Xo?--T|
MB-M--?X-----X-X--X?-X?--XoXE|-----B-?-----Mo-XBMT--T-----X-o?XE--E--EX-BT--B-BTo|M?M-M--M-T-?oE-TTE?E----o----M--M--EoBBT---?-BBM---EoMBM-B---X-??-oX--Xo--X-o|T|?oTE--EM--XEMX--BE--E------o-T-E-E--Ev
TM-E--EX|TBo----o?|----o------o-|-----T----E||--|--XX-----TT--?--M---T?|-----BMBB?---oX-X-X----MT|o-E----|--TBE-EEoEoE-M|o--T--B-T-|-|MEMT-oo---E-TB---o-?XB-TX----M--X--B----E-o-X--o--T--|BE-o-o-TM-M|
-E-E-|T|-B-oBo----BX----Mo-----o---o?TMB--o---oB---X----MEX--B----EM-----o---E|-----B--BXXEM-M---X--M----EB--o--M-o---T-------T-----|----||---E|BM??MBB----T---XB-o-|-E|-T-oTB?-Moo?-|B--T-?--oT---||??-
|oB-B----|--B--?--?--X?--|B----T?--B--TX-XoM--TX-B----E----B---ME?TT-?-|o--B-o-o-o-B-----TM---T--o-T---B--EE-X-B-?-oo-B?---TE--T--?--X?BB-X--BX|-B-B---oMX----Bo---X--|-XB?---E-?ooo-?---?|?|o----oB--XE
|--T--B-?BT----------oT?B?-TE-??-|EEB|Eo---??-Boo--oB--?oX--M-X-T---|B|---BM-oB?-oX--ET-X-----Mo-T--------|X-MT-E--|---E-------BB--???------T-TXMo-MM-|o-BM-BX-T--|-T--B--?-o---E---EE-|T-B-BEX?-MMB--EX
EM?--|oE-----||--XBX-M|XMM-XM-B---|E-M?E?-T----T--oX-|B--|?o-X---X--oX--B?-TXM|-?--B----BM--||X?M---oM-----E--B|XT-----XT----------X----o-Bo--oM-M--TX||-----EX-T-?EB------o-T-X--M-MB?------Bo?------M?
EM---T-XMB--|?-M--oX?o---B-?----T-----M---TEo|BE---B|----EXE-----B-EM--E?-?o-MM--?-MM--------TBoM----?|M-|-|---X-------?o--B---X-M??TB---X-|------T-E-XB-|B-M-TX--B-T---oo----|------E--|B-E-Eo-?Bo-oBB|
mB--|-|--T--o--?---?---T--B--X?-----E-B----X?----|-|--E--------MT-------XEE|---X---E|-B-B-|-o-o---T?oo---?T-E|T--||-Xo----M-BXE-MT-|--B--X|E?B----E----M-BME---?T-E-E-?o-BX-?--M|ET-?----|--M|--B---B-MM
XXXXXXXXXXXXXXXXXXXXXXXXXXXXXXXXXXXXXXXXXXXXXXXXXXXXXXXXXXXXXXXXXXXXXXXXXXXXXXXXXXXXXXXXXXXXXXXXXXXXXXXXXXXXXXXXXXXXXXXXXXXXXXXXXXXXXXXXXXXXXXXXXXXXXXXXXXXXXXXXXXXXXXXXXXXXXXXXXXXXXXXXXXXXXXXXXXXXXXXX
