B--E-TX-ETB-|--X?|-BEB----?-||M-XX-M-To-?-----?--M--|---TEX---BM-|------E-o--B----T-oE----BM----XooEB?----MMo|-B-----|-----o?-EE?--B----M?T?TTB--T-|--BM-T|---BB----?------T--E-?-TXoX-M----oE|-o-?---|o
T-?M---M--Eo---B-|-T-----B-B?--|--TBB------?E--E-EMM?-?-?-M|o?M--|oM----?--?-?--|---M-o-E-MXMo?-EM?E-?|-----oBMETX|-|-?-----E-MB-B-XBB|?----?-?----E-----|X-E-----|??-T---?---??-B?T---?-Xo-----T----M-|
o-E-B-----T--|-----E--TE||-B--MEB-E?M|-|-B-M-?--?|-----?--B----o-T---EEEM-|-----MTX-----?-T----B----?-?--T------B--T-----o|BB-?----XE------EB----X----|T----M-T-oEM-?EE-----o---BB?M-----?o?M-|?-----?-E
T--oo?-BX-?---o|-BET---B-T----o------------B--M------|-?E--MEB---M---B?--X----T--BB----T-|T---E----BB--|-MT---MB?TB|E|-X--o----B?-?X----T--?------M-X---|------o--E---|-M-TE---E--E|?TMB?-----XoB--M----
T-?-|EM-E---TME--M-|BT-M----BT-------B-?--E-|E-EXMBB------------E-------?MME-----E-?----B---MB------?-T-?XEoM---?-E-T---B??--------?M-??-----------o-MB-X----BB-E-|?---?ETo-T---BB?|-T-M--MM--|-X?T|-B-E
--M----TB-o-E----BBM--EE---?-T-EE--B-EM--E---|M-T?--M-|M--T-BT--BX--B-|B-M--B---?M-E--E-X---TM------T--BTE-B|--BT|--T-----o-B-----|----T--?--BM----M--T-T--E---?--?-||--B?-Bo----T--?M---|BB?--MTT----EB
X--E------|---T--?MB?-BMo---|?B---ET-----M--TM--|--T-X--?--TTB--B---EB-|B--M-MB---T---?---E--o--oM----?----E---B?-----B|----B--------oX--B-|------B---B-E-MB?--M-T-T-|---E--T?---BB-----------BE-T-|---E
--?T---?-||BT?-------T-??B-----------------|-TT-X--T-|T|T-----EEoB-BBT|-M--MBET-----E----|--------EM-MB-o--M----E---T---BXM-----T-|--MT-o-TXBo---T--B--o-T-EX----B--Mo---T--?----T--BBM-E---B-------E--v
o-EoB-BoB??-T--BT-B----?--|?------B--E-BE-B---M--M?-oB-o-|-------|MMT-|E----o-BM-X---o--E--M--------X---?---B-ET-|------XB|-EE-|-----B-E-B-?BE-BM-?BT--B-B--||--?-M|?-?---T--T----?-BM-o--M-MBB------EX|
?BMoT?--B-B----oEX-MBMM-----o?-o?-M-?-Bo-T-?--B-?----|--?---|-E-|E--E|----M--B|-o-X---T-------TM-TETX-?----M?----X---T-M-EM|-|------??-?-TT--BMM-||-|----E--B----|BE-MEE-TB-MTT-B--M----T---T-E--|----M-
MBo?----?T---BE-TXE-----BToMEXoM-Mo--ME--B-Eo--B-------B--To?E-B-?---Xo|oBM--------TBET--XB-B-BTXX----||E--MT--B-B-----TET----B-M---|-?-----M-B-T?-o-----?---EE?-MM-B-------BMM-o--M-M-M--T?----EB-BB--o
|o-TBT---E--E-------o-?M|-E|--?-----EBE--||-o----T-E--BT---B--M------M---TE?-BBToTXTE--B-B-B----X--oX-M|T-|o--E--|M?----B---?--B?M--X?-BBB-----TT?-?T--BE?-BXBX-o-------o-B-XBB-X--MB--|--|-EM--?--M-M-o
|M??TETM--TT----M----------?o-------B?----?-|---TT---Eo--M--?---X-B--E-BX-T-E-T-B-EB---M----T----?---BM-BB----T|X---|-T---o|M-----|-B---MoMX-T-EM-M--B--T-------TTo----Xo-|---MB-------------B-------|--
E----Mo-?-E?TT-E|T-o-B--E--?-X-T-|---------E?----|-B-E-o--M--M----B-|----T---E--M---M--------?B--|--------------EB-T-?T----o-T--?TB--o-|----------B-|E-TB---|--???B-oE--T---B--ET-M-ME|T?BB-B---B-B--T-|
mE--------B|-o?--BBoMM--Bo--?-?-M---|B|X-----B?-E-M---BX-E-----TT-ETM---M-B---B---?BB-T--?o-------o-BoE-?--T-?E|-|-?--|E-----o----E--MM?o|-o-T----X-MBE?-M---M?--B------E---oM?--T?X-BMT---BM-EB?-T--B-?
XX---XXXX---XXX-XXXXXXXXXX-X-X--XX-XX-XXXX-X-----XX-XXXXXX----X-X-X--X--XX--X--XXXX-X-X--X--X--XX-X--X--X-XX---X-XX-XXXXX--XXXX---X--X-X--X-XX--XX--X-X-----XX-XXX---XX-X--X-XXXX---X--XXX--X-XX-X-X-X-X
