o?-----|-?o--E-|----?-M?-o--E--o--T-M----T-oT--T-----?Mo----?TT-B?o---E--B--|------M--B-EET?BE------?M-|----B--o--E-----|-M-MoT--|--|-B----o-BX--XM-MEET-EXMoM----------M--T--ME-oTM-----o---TE---M-X-E|
MMo-TX|-M?|X--TE?-X-XEMBE-M|---E|X--T--BMM|MB--TM--|-o--B--|----|TT-XEE-TTEM|E-E-T----oTXXM--M-X|-?--M-MM------o-TT|M--o----------o--M--M---?X--Mo?-E--?-E?o??-o--|-B-E--M-?B--T?-oM-MoT-----|----?M---?
oT?oM--|-M---?---|M|--?----------|--?--?oT-M-----oE----?M--E----o-T--T-Bo-------T---|?-|-BooM--T--X--M-?--o---T------B||X-?--TXTE--||-B-E-B-M---TX-|Bo--oB-T-BE??o-----E|-X?--T-o--X|-M--ET--E?-T?|-XT-?
T-M--XXB-X---?X-?-B-----BT-------E|E-M------|--X--T----E--o?-BB?-TBX-------o--TTBoX---M?E-TEE-------?-o----??M---X|E-MBMX---oT--XT--|-M|oXM----TT-----o-------o----TM-o-?B--Moo--?MXB|---XTMB-T-?X-XoBTo
B---?ETo--T-oX?--TMMo----E--B--BE-T-BM?-E?|T--|---BB|-|MXX-B?E----M--BM-|-?E--B-XTo------|--B-------o------o|TT?-----MT|--E--|?-----o-----T--E-----TT-oM-MMT-M----TX--B-X-oTT-B---o----XoM--oX-------oM-
|----TX|---TX--o-o-||XEBMM?----?XT-|--?|---XX------M-TEMEBMoBT----T--X---E-?E?|---|XT-|EE?-----------X--o----BM--X--XM-----?B---?|BM-B---|----?--X-B--X--E----?----X|B--|X-E--T---X?---------MEB-oEX-TE-
o---?M-E------MB--o------o?o-B--M-----M-X?------MB|--E?---T--E--X|B|-?|--o?XT-----E-T---oEo-E-B--X-BM-----------?--M?M?-B-T---?-|--XMX----o?-X---o-XT--EB-XB-TB----TE--BMB-B-M-M---B-Bo---X--X---XoXE--o
T-------B-o-BEM------X?---?-M--|--MXXBE-----T-T-?X|X-Eo---BX-E--oo-Xo--B----?--MEoo---|B?--M-T-oB--X------M-BXo--M-|?-BM--T||E-T?-|E-M----XEMo--MTX--XT-ET-oX|-|-M?o--T---?-T--B-?---?o-o---TT--?ME|-M-v
M||E----E---|----|-o-M|--T-M------?---------M?--o---|-B--M----BM----E----TXXBM-M-------T-T?--E-?T??o-T-?--B-EM-----E----X-TX?ToX--BB----oT---M------T---X-EX|--B-----M--X--Bo--B--X-XM-|---?--TE|X-M----
B------?E---o-BoTTM--XE-------?|-M-X----|BM----B-B-oo?--?----o-T-o----E-ME-o|-T-------XT--BX---?E|BoE-T-??--|----B--X---------EB-X--B----M---To-T-M------T--------o----o-?--M--?o-MXX--|----TM-TM--T?-oB
ooB-MX--oo-M----?|B---M--XB|T-|o---E-o-|oB---M-?-XE-------?----E----EB---Eo------o--X-oE-X-M--o--|---X----o--X-T-?o---E|--BX----?--E-oX----|-------M--E-o---MX------------EM-BE------|?TE-|---|-XBE----X
|M?E------TB---MM--XT|----B--|----o--BT-----oM--T---B----o----MX-ETT---|EE?|----ME----T-|o-oX?XM---M?----oX--o--M---|T----?X---?ToEE------|M?X-E--|E-BE--oBB?T-T|-?B-T-----?E-|-ME--------T--|-T-X--B--E
M-B--M--oT-X-|----------|----|-Bo-?|--T-E--T-EMT-EM--MoE-BM-E--BTE----|-T---?EE-|----M---B|?-o-----X--Eo-BM|--?M?-----|--------|-o-------M-Eo-E---T-o--|oBX-EMBB----|--TT-----||M----B---|M-XE?-X-MB?oTX
|?--o----ME---X-BM-o|-|BMB--TBT-o-B|-X?-?T-E-E??-XoT?---?-|M?o-ETE-----T-MBEX-M-?------XXB-------BT-?XTEX----MTM--|-o---M----o-|--MEE|-X-B--M----B--E?-E--|E|--XTT|XE------|-oT---|--MT-M-----|-M--B---?
m--E--XB-M-TT---MX---o----|B?o--o--B-TXX--X------|-----|EE--o--?-MM--E--B---|oo--?-----?---|-|--T----TM--------EoE-T----M-ToM-B-BT--T--TXT|-B-|MX-|B?-XEE|---?TX-------?--?B-?T-X?X-?----B------T-E-??TT
XXXXXXXXXXXXXXXXXXXXXXXXXXXXXXXXXXXXXXXXXXXXXXXXXXXXXXXXXXXXXXXXXXXXXXXXXXXXXXXXXXXXXXXXXXXXXXXXXXXXXXXXXXXXXXXXXXXXXXXXXXXXXXXXXXXXXXXXXXXXXXXXXXXXXXXXXXXXXXXXXXXXXXXXXXXXXXXXXXXXXXXXXXXXXXXXXXXXXXXX
