E--M|---o-T-TBE--|B--Eo-M--X---|--X-|oT--XX-Xo-E-E----|o-?|---BB|?|o-TEX?EBo-BB-XTX|--XM-oM-------?T-X---T-TX--?--?-M---TT-T-|--M----T|M-B-X|---TM--?o-XBBM-?o-?T--E--o-oB?X-XB----?-B-?-M-MX--M--M----?
MM---E--?----BToE--------E--MMT-TX---TBXEE---?B-|---B-oB--?oTX|BMo--T|X-M--M----X---EX?-Bo|oMEX|?---T---M|-EXT-B----XXMB---B---?T-M|XEM|---BT-M--X---M---XB----EBM-?--------BTX|?------E--|--ET|-|oMT--|
|X-o-|-TB--M-TMoE-X|----M-?TXo?---X-TB----E-M--TMB-T-MTT---TM-|--?-o--E------XB|M-XBT-------B-|-XTB--M---?-|--X--?X-BMT-EX?X-|?------XM-T|--T-M---B?M-?-|o--ToB|-|E-Too--BT---o----E---|----||-E--|--MXE
TBo-|---T-E---o---MT||-?Xo--B?M---X|T-EB-|-T---BB-T|E----oT|BB?ETM--E----MM-EMXB--E--M-BM--B--?-XX---?--------E?oM-?XTX-o-|-EBX--?---T-oEB--|-BB-T----?E--E-?--??E--o--BM-----MEME-T-M-------M|-T------?
EM-|--XE-o------M---M----?-o---M----E----BX-M-?T--E|-T----XET-T-T-|?E----|-o----E----MTB-X-o------E--XM-o-T---?-E-TE-X--To-XM|?------M|E-B|?X-?E-M--XXB--E-|--oT-?-?-BTX|--E|B-T--XoBB--XM-EB-XX?Mo-----
--T---MT----|--|-B----T--BXT-?-B--T|T-XoX-----B-XT-------Mo-o-oX-oX-|--?-?X?MB----M--o--|?Bo-o---XT-----B--o|TXM--EBX----XT---E-B?---?--EMX-T--o|-|-Eo?---|E-?--?-M-oE-X--|o-T--E-?T--?||oM-B-|----o--?E
o----BBoE-?---ooE?E---X-EMoBE--E-M|----XE--M--------|T--?MM-o--T-EB----TXM--B??---EE-?oTX---T--o-M--o---XB-M-T----------?-EoXo----M---|-B------M-MM-B-oM-T-??---|?XM-?B?-XB----M---B-M--o?-B-B---|---B-M
oBBT---?M?TT-|-----Mo-----X----E--EE------|-E-MM|X-B-?|TMo----oo-o------EM-E|---oBo--?M----X-o-?BM-||-?-o-X--M--T--EXXB----|o?---TEo|-----T|B?-X--o-BM?--M-|---|--BX-?M----To?X?-XX----|-o--X-?o-MTM---v
BB-M?-E-T?-TT-To---EXM-T|-E---M----T--X-|X--|----MB?--E---B---M--|o|-X-?|-----oTX--oB-o---oEB--T---Mo-T---XTT--T-|---M|--E|-Xo--T?-X--M---X--||X?E--XM---T?oE-EM-MM--o-|--o|-XXE|----BM?-------X--EX-M-X
o-BTMEo----EM------T-B?-|B------?||-M-|-?BEooXX-XTXB------XE-?--o-T--E-B--T-T-XM-----?XT--------------M-----BXEMEo-X--?-|T-T?------T-|?-|-----|-T--o--|-----M-B---o-|-T--|M-EEE--BXo|----|M----TXTXB-X-E
E-Mo-BX---XB--B------B-?T--E--XB---M--?--BEM----B-X-o|T----?--TM?X--|---o-T?--?X------|XoX-?T---T---BM-o---T--T-oo?B--X--B--BE---o-E----X---o--BTT-B----?o-X-TX--?-E?-M-oE?-ETM-|Eo|?BE--|-BB-o-X-EMEX--
XX---------T|----XBM------------|-T-M-B--E--Bo-EMX--Eo---E---TEB-oT-T------MM--X-EX--M?-E---|BE-MM-M--E--|--T---E--ET------ooX-|X---MBBE---XTo|?---X-|o--oM--X-TXX-Boo-o-M--|M-EEo-o---T-oo--|TXBM-X-MTE
MM----B|B-TX--EMT-M?-B--XT??E-E--BE--E--BTo-??|--MoB--X------EMo?E-|---X---E|-E|-----------T----M--T?-E-----|??MToTB-XBB--?-oB--XTEX---o---------M-MXEXB---??-|XM--??---BoX-M-----T--T-B----M-T-?X??--TB
X|---Bo-To|-?--?-o-B--TE--X-Mo--B-----|-|-M----M---B-B-EB-E-B-BB----X|--B-----M|-B---E---M-|--TE-M------B--?----X--M-TT--BEME--oE----B---|MBo--?X--E---M------o----T-|-TM-BTE|------XT-|--E|B-|-T--||B-X
m-Xo-B-XE---TT|--M-Xo|-Mo--?TT-Xo--o--TE-|-Boo--EX?----ET|---------o-E-XM----T------B-EE-T-M----o-------B---MX---o-E-TB|B--M-o-|B---|M-ME--oM--M-------TEM---|----T-T-----E-B---T-M|-MoX--BoTBM---?-EM-E
XXXXXXXXXXXXXXXXXXXXXXXXXXXXXXXXXXXXXXXXXXXXXXXXXXXXXXXXXXXXXXXXXXXXXXXXXXXXXXXXXXXXXXXXXXXXXXXXXXXXXXXXXXXXXXXXXXXXXXXXXXXXXXXXXXXXXXXXXXXXXXXXXXXXXXXXXXXXXXXXXXXXXXXXXXXXXXXXXXXXXXXXXXXXXXXXXXXXXXXX
