|B----M?--?--T?E---?---ET-|--E-?E--XB--oB----|M--oT--o-?--?E----E?M-B|--M---Xo---oTTM?-----MM-X--?--M--B-|---X?--E|BE-?-X----TE--o|-----------MM-|E|M----M-M-M-----?B?-M--X----E||-ToM----oM--X--o-|---E
|B-X|-----E-B-T--------T--?|-X-TB-M-o-M-E-B?-M--M-oB--EX-X-M-XB--T--X-B-E--------E?BBT-TB-|T??|M-BM-T-------|--M-----BEBT---|T?-E-?|-B-T|--------|B-|---E-B---T--BEE---|ETBT-X--B----M-------XE--M-oE-TM
X----?-T|----E--BEBT-BoME-------o|B--X-X-|-B-BM-X-----XE|-----o-T-X-B|M---MX-|---?--|-MT--EE-M-E--B-|MB?-----T-B?M||---?o-X?X--MM-T-------E|BoT---?-T---E-|----B|--o---X-BE--MBTX-B---XB---M-TX?-MX-X||E
M------T---?-?-?T-----E-----X-?|-T----E|-X|---T---B-BT-T-TE--T-|-?-----X-X--E---oo-EEX--T---|XTTME-?E--?T---M--?--|-XEMBB--MEETM-TMM??E-M--E---To-----BTX----MX-X-?X-TM--|EB?E|?--MXTT--BBT--?ToE-E?--BE
E-BoMM-BB-ETE-X---oT--E-------E----E------BB-E-----|E-M--EB?B---TB-B-?-E-EBT|-?--B---M--X-------T?---E---T---X----B-|?-T---MMX-To-|B--B-----B----E----|B---E-X-B--T---?-T--M?-T-Eo-|M---?--?M-ET--|-?|Bo
M---X---EEE?T-M---XoM?---Xo|BX--?----BB---T?---|M-EB--?-|---?-T---B----?--?B?o----BME----E----E?T-M--|-E|?-----------B-|-?-M-T-|------E|-E----BE?T--?---X-X?B--oB-?-o|B-X-T--B--B---E---|?XB--B--|-E---X
o----B--E-----E--XEE----Mo-o--B----E-EX-M|B---X--o---BEE-|o---BXE-XB?B----MX-T--T---B--TM-B?--M-E-----|?BX-MB-X|---B--|-?--M-MT-?-M-|--ME?----E-|oX-----B----------MMB-----TT--B--BB-----oo----M----o---
-|-B-|--?-----o-----?-?B-o-T--|-T--------X--TT--|---BB-XB--E-T--o--?-M||----?EXM|-T-B-?---B----E-?|-X--BE---|E-X-X|----?----B-?--?-BBXMXTB-?o---|T-E-M-M-Xo-------|-XoX-|TBE?--B-B|E--o-EE--Mo---BX---Xv
T|----X----B-?-Bo-E--??BB--|ME-EX?---M-X--E-X|oo----T-------XT-M-B---T----EMEB--M-B-B|--?---B|T---B----?-E?--T-----T----E-MB----?|---------------?-EoB----B--?---M|-?-E|-X--Xo----XM-B--?-----X?B|X--|E-
MB-EB---?----?o-?M----XB----EB----T|-BT---M---E-BB?-ME-MBMB?E-E--X-E-XT--T-E--T-M-BE--X-o|---TB--?----BE?BM-?M---T?XTB--------?EBMT-E---E----?MT--?X|-?X|-B---BX-EMMX?M----XM--B-?-o-E--o-|M--|X|----TE|
?o--B---TX-|?-XB-M-o--------|-M|---?-oM-|B-?|-----T--E?B-B-B-M?oT-T?|-To|--------E-----|T|M-?----?E-X|M----M--|-----|--M-B-T----|---XBT----M-MBB-XM---E---B--B--?o??-??E-??-T-?MBB--E?-o|MM-X?EM--BE--X|
B-BM-T|T-E--M------XM|--T|---TT-M-B|-T---T---T-----BTMT--T-T-B--ET-BX--To--T-??--XB---MEMEM--MB-M-?|--T-----Mo-T||--MM-E--|-------B--T??--BT?X-|TBBB|-|?--B|ET?B-E-?-------B-----E-B------T--B----BM---E
MM?-?------X|E|BE-?M--|-|M-oBE--XE--BBoE-?B---M--T--?-------To|TB-Bo---ETT--?---?T?-E--E--BB--TEE-----Mo--T--E--oT-M----XEo|----MX-ME-|-----T---BBB----|?-?-?------BE--|X-B-T--TM----o--X-E-B--MB-BMB-EX
E-T--B--E-B|-ET--T--X-B---E-EX-----EEB-X--?-M?-E-M|-BX--?----M--B--T---BE---E--X----BE|-BM-ME--BTMX-?--M-|X---|M---EBT-B--TM-----o-EXTEE---B--B-?E?-?--?|-|E-M--B-----EB??M?TE-B----|T-|-X||---E----|BEo
m-T??T||---?B-|-B-----M-----|--X---B|---?|-o--T-|XM---EE-ME?T----|-|o-T---|---BE-----BX--M-B-oTMT-o----EoX---o---BT--T---------|?MB-MBB----E-M--M----||X-|----X?--TXB?---B|T-----|---E--E-----E|-M-|--M|
X--o-o-oo--oooooo-ooooooo--o---o----oo----o-o-oo--oooo-o----oo-o--oo-oooooo-o-o-o-oo---o---ooooooooooo---oo-o---ooooooo---ooo-oo--oooo--oo-----o--o---oo-oo--oo---oo--oo--oooo-o-oo-oo------oo--o-o-o--X
