|--B-X-|EX??-BT-XX-?ETMXX-To--E-----o--T-|------T--?B?E--T?X-Bo?E-?E-|---M-?T-E-EM--?-TE|---XT-T-ToTE---B-E---Eo---X?--o-X---XE|--oB-|o-T--X-o--|--M--?----B-X--|-----o-??----B-XMB----M--X-----XM---X-|
X---|---MM--X--BXT-TTo|-EX?----------B-?------XMM---B-M---M|MB--B----XE--B|----M---------E-----X--TX--M?-XE-|---ETMT?----E----XoT-T----TM?-?----X---TTM--------|---T---??o?----T-B----B----E|EMEEX-To-|?
X-?-MMX|B---||-ME--B-B---?-BXM----TX--E?-M-----M-?BT-M-M?T--------B|-|BB-o-EE-?-|-T------EX|-M----|X-?|XTT-?--T--X--ME---?---T--EB----|B-E--B--o-BE?EBB--|---T-|-?Bo---M--X--?BMo-?B?X-----B-E------?-MM
?-------B-E---T-T-B----B--XTM-Eo--?-M-X--ET-B-E?-?E-----X-oX------X|-BT---?---|oM-??-----B-TME--X|-----E----B--BXB---X?--|-M|T-T-T-|oT----BT-MB-B-T-?T-|-----?-XBXTXT-MM-X-|XB-|---T--E--X-XB-M--E?B|-?|
--E-X-M-TEX---TE-T---T-TME?-E----EM--B|----E-B?--oM--M--X-E-?------E--|--o--E--B--B-Bo--E--T---oXE---X-?--M?--M-MXB-TBX--|B--T?E--X-oX---B-MT|B-?-B-MB---X-EB---oB---E|--T-B-----E---EX-----------B|-|EE
?E--TE----------?-X?E-BMoTM-MBT-|-----X|-|----TT--B?E--?|----T---B?-B-?B--o-EBBT-X--E---M---|-|T-X--M-T-|-X------X----XE-B--B--TX---BXTE-?E-?----M--MMB--|-----B?|----TM-------BX-B----Xo-----??-B-|E-TM
M|B-|B|----BX---B----B--T-B-E--EM--|----|---|-|-MX-?--E--TE-XTB-TT-?To-E-------Mo--?XT--B-oX-----?-B---B--TM--M|-TMT-T--B--|----TT-XT-------ETB?---XB--M--ME-XoB----B----o-----|-B--?M---TE---?-EBT-B--X
B---|----oX-|--EET--B--?-M---B-B---EB-XT-----MBB-|BB-|--?E---B--X----?X--MBX--MTMM-BB---?---?E-T|M?---XT---|-T-?MX?X--|-----B--E--?--XEM--X----X---|B?-BT---|T--|--EE--M|-X-T-?E-BB|----B-M--?|B---M---v
XB|--MB--TX--------B---XMo--M---X-MMX-M-?-M--|M---T|----?--X---M-T?|-X-?-----TB|---E--ET-|-T--E?T--MTX-----X-M-B-?o--T?MB--o---EM---T-o?----oX------------o--T|---o-TBB-E?--T-T|TTTX-|E------MBM-?------
B----?|E-B----EX---E?---?B?-o--|BE-T-?--?-------?-----X-EXBE--X----B----M?--M--E||oB?BE-?|B-B|--M---B--B--B??MMTTEB----------|--T--MBXBBMo-?---E|-o||--BE-|-|?-?---------|-?X--B-----B------X---B?-T-EBM
?B-?T|??BT?|-X---M?--|BE?--E-B--MEoE-M|-T?E|E--M-M-|TBT------X--MoM-o--ET?--B?-BT-M-M---M-?oX-B|--X-oT-XB---M-??--T---X---BX-B--?B?--BX----T--B-o-?E-|T--?MT-ToX--X---|---E------o--?-T|---|E-----|TB--?
E--B-XT-oM----?|-|B--B?---E--EMX-?-X|-E-?oM--MEXT---|T-T--T---oE|-----MM---o?----?---To-E--??-B|E|---------T|--|??M---|----T----?M-o---|---------ME---B---E?B-E-oX-X-----B--TB-B------o---M--B-X---B-TXB
E-XB---ET-X-X?EB---?-T-E-B-M-TE|EEB--|---TM--MBT------?MM-M---EEB--X---BT--?-----EX-MM-M-----T---oB--T-?|M---B-M--B-?XMX-|-E----?-B-E|M-?MEB|--|----|---XB-X---|oT----X---MB-XM----|B--BT--oEEEE--B|---|
|E--T-X-E-|-TT----?-T|ooX-?-B-X---?-|B??T--TX---BB----X?|EoX--X---B--?E---XEX--o--?---?--TETX-?-XME----BMBo-EE----X-B--B---?----?-Eo?--|-E----M-E-?--X|??-E|E|---M---M---|Bo-B-BT--X|---XBoB-|---?-?|-|?
mo-BME-TB-BX?----||-?--B-----B-B-----o---o--M-|BM-?B-----o?oX-MT?E-o---o?M-?-E--X?-----B-?--?B-E-T---E-------E----TMM?----XMT-|-E?E---B--ET--?----X-o----EX|-?BMX-?E--MX----TX?-----BB--------MT-|-----E
X--oooooo-o-oo-oooo--ooo-o-------oooo-o-o-o-----ooo-o--oo-o--ooo-----oooo-o--o--o-o--oo--o--o----o---------o---oooooooooo---o-o-oo-oo--oooo-ooo-----ooo-ooo--oo-ooooo----o-oo--ooooo---o----o-----o--o-X
