BoM??---TM?E-TB?-B-E----M--BT--X?-?Xo-T-ET-|B-T--|o--TE----|---?--EB--X-X||MB-T?o-o-T?X-T------o--TXo-BXM|------EET--Moo-X-|M-B----TBX----o||-oTo--|--E-M--|XXBB-E------?--TE-?oX----B-----M?MTTE--M---o
XX--BMX--|E-B-|T?Bo-M--------o?EB--E?B-----B---E-T|-EM-TM-|EE---|--------|o-|oX---ME--EM--B--E-?--X-MT--M-|M---MT-o--BM|-B-|ME-XTB---M-B-B-|E-----BX---|-EB-?TM------ET?--M-B--XB-T-----E-BEB?----M|EB-|
BBB|--M-|----?M---MBE?T-M|--E--B--|---E---BTB?-M--T---------B|-|?-T---B--T--B--?--oT-oE---T-|T-T---T?---T--X------T?o-?o--|-T---|o--|-ETT---E-B?T---B?BEEXT----X--------T---------T--TE--oE-?-BB-X-E---o
B-------EB---|---|----M-----?---?-B--Bo|-?MBE-o----M|--B-M-XXoBE|--|E--T--ET----X|-M|------M-T-----?--E-??-T-EE-----B---T--E-----o-?X----oM-EMT|--E--MTE---XTTME-EB-B--BT----------oMB|B--?X--EM|Mo-M?-|
X--M|---XB--To---E-M---E----|ET--TBoXE-M-B-?---|----T|-TB-|----?-X-T-?MXo-o-MT|-BE|MB-------T--|--E----?-BB-------E----ETB--E--BBB--B-------B-----MBB|?--X--T-?XTMM----XB-----X---E-|-|B-E--------?T-|?|
|B--|-----B----??--B-B---|E-o-----E--|-?-?-BE------To--|--XBMB---MTTM--M---?ETBX------|EB----B--MM----|---T--|-|--?o-?EBM-BE--E----T-----B-MB-B-B|E----T----TB---B----Mo-BE---|--M---?---|E--oE-B----B-X
XB--|--?----E-XE-X-M-----B-?-B--||-E---M-|-M||--T?-----?E--|B-----|BB------T-EM-?--E--TE-?-o-|-TMBo?--EX-T-----------?E---?-?-X-X-?TTX-E----o-E----|M-E--MT--T--E-E-M-----EMB-X---M|-M-E----X--||---|-B?
B-o-M--?B--oo|-M---B-M-------TB------TB-X?o-X?T---MX-----B----o----oMB--T---BB|-T-------|--|-B----BB---|-|-M|-E-----?-TB---B----M-B?-o--X--|----oE--X--MM-|E-?---T-ME--T-----T-MB------ME-EM-?-M?--T?--v
?-||XBB-B--TXX?--oBEE--E-B---B-o---X-BEM-T---B-o--?--EET-?------M|-?-M--o----??T|--?T--X----MM---TM--B-B|--|--?--oEE--Xoo---B-T-|?------MT--TT|-B---?-|-?-BE--------BET-----------o-|--o-T-------M-E-|-T
|?---o--E?-B-B--B-T-o----M-E--|--T-EB?-BE|X-M--E---B--E-MX--oT-B-E-----oo-?---B-M?o----E---M-B--E----BME---?o|E-B-X-MMBM-----T-X--?T----E--B-|E-B-|B-XBB--------T-o-?-|-B--B|--T-----?----XM|---E----M-o
-o---T----E-X-?-|-oBE-----X-------E-T-?--M|--?-o--M?------o-T--M--B---?|--?M---Bo?T|E?-TMB-B-------?-X-M--?B-----T-M-|E|---?E-B-----|-B--XB-M|?-M-----TB-Mo-----B|--|M--|-E--|MB-XE-XT-M-E||--|-T-|--X-o
M-M---?----E-|E-o------B|o------M-----ME------?B------EB--?||X---EEEMB----|--T----?o--?-M-M-TT-MTX---B-X?B----|EX--E-o?-TB--MT--B-|-M-M?-T?T--B----?---?-----BBT-----B|---TB-B-|--XM--T-o--X-o-----oMT-E
E-B-E--?o|----o-XBM------??------T-----?-E-B-B-TB----B-EX-----BT--T-B-X-?EE-X---o--B--TT-o-?--TT----E------||--?--MET?|BE-X-o--E-------?--TM---M-o----M------T-T---BM|--?BE--|T------B?-E-o------TM---|M
T----||--o-M--------T-----------TB--E|oX?T--??-----E-M-E-----E----T?-?--|----EX-MB-MM|E?----X|X-MT--------|--T-TEB-X-E---?--M-B-----B-|MM|--MT---T----o|--E-|-T-T--?-----M---BE---o---T---BX-----|-----?
m-B-----X---XT-------M---T?B-?B---?-B-|BMooBXTB-TE--T?-----M---M?|-M----|oBM---------E-B-?---E|----M----BBT-B--X-E--o----M?oo--X-M-XB-o--o|----?-E--|--T-T--T|?E--T--MEET--M-BM---B--|B---E?-----M-X|-TT
XXX--------X-X-XXXX-X--X-X-XXX---XXX-XX-XXX--XXXXXX--XX---X-X-XX-X-X-XX-X----XX--X-X-X-XX-XXX-XXXX----XX-X-X-X-X----X-XXX--X------XX-XX-X-XXX-XXXX-XX--XX-XX--X---XX-XXX-XX-----XXXX------XX----X-X--XXX
