?E-XM---T-E--?-?T-B----BX----o?----BX----T-------ET-M---?--?MB?-XX-E-o|---o---?----oo---M|----o----o-?-T-oE?--------X--To?BTE---?XX|-BTM-------B?-oM||o----|o|--X-|-|-|?T--o-B--ME-|---M-----|T-o---oo-X
B--X----EE---E--TBoM--TT--MM--BTT|?M-M---EMM--T---M-T-----B-------XE---B-TE--|--||----o-Bo----|-------------|-E?--T?|BE-------E-X-?---To-T--T-EEM|TEX-MM--?B-----M--B---?-B---?-|-XB-ME--BE-B---|-BBBE-o
E|T?M-o-M-------BX-XEE-|T--?----M-?-M-E--MT-o---o-----X-BB-T?||E-Bo--???B-----|-B--MX--?------o---B-?---EBB?MEE-----BBBT--XoM---------B-T--?-------o-o---?TT-E---EXM-o----|---E--E--?----E-T-?---B|----o
|-X--TB--oE-M?----T--BT|-|ooT--M?-|o---|o---MB-??E|?ME---o----B---TM---M-X-B-E?BM--|------|?B-M?M---XB--E---o--EXM----B-------|--T?--M-T--B?-B|---BM?|--|-B|T--T--B--BEBM?-?M--o-|M|M?-|---|X-?-E----|--
X----|-M--M--B---BoX|----?M-E---X---T---|-E----T--BBT---T-----|-----T---------o----?M--BT|--?-o-B-?---o------?BTB-Eo--E-B---?------|T--T----XM--M??-|---?|--E--X|-----|-----B-|X-??E-----E--BM--|--B-||T
X?-|-BoT--BB------X--o---M-T--?|-M-o-B-TT--B---B?---|-|M|----MXMB|?-B--B?--B---?---?-----|o---M-EE------o-X-?-MM---T---Eo|--B-XM?M----M-TBX-----E--|?--|XE----MX---ET-T-?E--|M--M--------M----|Bo--?E-EX
TX||T-------M-----?T--T-o??--|---XME-BE-|-B-X?--B-T?--M?TM-EE-?M?---?-|--M---B||?-----o|-B?-o?o?T---E-M---T--|BX--?-E-----X----EM---B-T-----T--T-B-----?-----|--?--E|-T-E?--BXMBXT--M--T??-B-|---MX-Xo|-
M--E--|-T-|-------B|BT-MB-X-B---o--|--MX--o--B-B-|-MEM----M-----M--?T-|------T?-|-o-M----EM--T-|-M----E-?B-E?M-TM-----------|X-B-E-XE----X?--M--B--o--?-B--TMM-M----|MBMM--EE--B-BBBB-T-E--|oBTB--B?M--v
?-|-M?--X--T-?--B----TM-------E---B----X-B---T-?----B-M|-EX-?B-|T-T-B----E---EM-B--E|--E-TME-E|T-|-|-MBM-M--BB--|--T-oX-TE-----B-TM--------|-B-B--|--o-|-------BB-E--|M-B-?-E---B--|EM--|----M-B|----?-E
B------|-TMTMB--o-XBEE---M-E?|-|-B-E?T--?-TM-E--TEE-?-----E-E---T--MT------BT------?-M-|-?--------?B|-----B-E|--TM|-o-oT---E---o--BM|-MT----------B-X----|--|o-oET|T-X--B--X-M-TB---------E?---??BB-?--M
X-B-?-M---o?|?---oBTT--B---M-B--E--X?--oT--X--|X?----B----|E-MBEBX-B|-MXBE----M----------EE--E-B----E-M?--|-B--M|--T---EXB---o--M------B?---BXMTB---oX-?TT-B-E-M-B---|-|E?--T-T-EE-M-MM-----?-B-M|---|-?
M----?-----ET?----?-------T---?BT?-X-E----EM----Bo-?E--M----E-oo?B--E-B--EETM---T---T---T-MTEE-----E?--oB--BBT-o|B-TT-MT--M?-MT----E-|-?-------EB-?-B|--?--X------T-----------|----?o-|-XE---?B--X---E-M
E-|-?-----------X--?-?--|M---o-|--TM------T?-TT?oB?E---EM?----E--M---|?--E-|----TBT-----M--|------B-TTB-|M-B----|-|-T-----T---T---T--------|E-|B-------------E--------B|-T-|M--B-----?-B-?--X--B-------B
o|--TE--T--M?--B-BM??M--X-o--B-X---||------|M----TE?T|X-o----M----?B-X-|--?--|?------|-|MT|-T----?---E-TB--------B--T-B---|--|-T------?-----E------o-B-?--E-Bo-----?-----T--o-X---M-E--E--B|--E?To--B--E
mE-X-|--XX--T?-?--T?E?B-EM------MB-B---?-------B?-Bo-T-E-X----T-T|MM||--oE-E--M--E-ET?X----E---|-E-?--XT--|?|-E----TX--X--ETE-M?B--oE-EET--B--?--MBB--MBX---T-T--o-M--o?------|E|MEE--M--M?----X--E----E
X-X--X---X-X-XX-XX-XXX--X-X--------XXX-X--X--XXX----X--X-X-XXXXX--XXX-XX-----X--XX-X--XX--XX-XX-XX--XX----XXX--X--XXXX--X--X--X-XXXX---X------XXX---XX--XXX----XXXXX--XXX--XXX--XXXX--X-X-X-X--X-X-X---X
