Xooo-TB-?--|M-B--|---X?|-----?--|T---E-M|--M--|-?-B--oX---?EM-M?X---TTE---M-X---X--|---E-|---|-M-----oT--oX--Bo-E?o--B?-?X-XX---|MT-M-?-|-?-|T-----o--E---B---E-T--???-B---|-X-ME---|--?B--?X--E?T---M-T
BMT||?B--B---------------EB-----E--?----B-MMB?--B-B?B-oB--------T--M|-?T--B--B-?-M----B--M---------B-|?-XET-T----BB-?-?----------?-----T-BMX--EE-|-----BT-XE-B---TXEEo-EM-------B-MM-----|-XM-|--TB-----
EB?------E---|o----o------|---|Mo-EE-M--BE--|-?-T-M-M?||--?-|-|-|--|-?oE----T-?-||TBM-|-BM-E--B-X---BXM-------?E-M|M---B----BE-B--B-M---T--BBE-M--T-XM---||---X----?TB-XXM--?-T---|EMX-BE-|----o--T?X-?o
o----X-M----|-|MBB---MM-?---ME?M|TT-B-E-E--o--TT----B-M-T--?-E--MT-------M-|X----?----X-|------?-----B-----T-B--MM--------MX---EB-?M-----B--To---B-||-?-E??-|---|----T-M-MM-|?E-?B---E|B--|o-----||B--BX
T-----------o-T----?-M-Mo--T----?--M--B----E||o--EX--?|-----?M--M--M---BB?-----X-T-X----?-E-M-----T-?-T-o--?T--T-BM--BT---?---B---------E---B--------?--BB---E-M?BB-E---|T-EX-B-BXM--EB?-----X-BE?|--E-?
-o---T-X---BB-BEo-|-----ME------------T-B---?---TM---?---?X---TE----B--T-X-E-------|--EE----?----B-----E--oMM--?M-E--oBMo|-o--?-M-|---o-BBM-o-BEM-||EE?-T-?---E-----MX-E-----E---BE-TM--T?---To--BB----M
MBM---?----M?|--T-|-----B|-E---E-M-BM--B?-B--E----E-T--M|-X?-|-B|-|--M-o--M-----?-----M---MB?-M-MM--B?-TX---M--B-----oo----?----TXo----B-T?B-E-T---M-|-B-B---|-ETo|--B-M|--EB-o|B-o----B----MBEBE-o-M-|B
---TMT--?Eo--|--E-T----M-M----B?T-|---To-X|--?T-----T-M-T---?-o-M---X----T|----B-M---M|?B---|EB|M-B-----B-|?-?---?-BE-X--E----|B-B--------BT--------BB-B--X--E-M--oMoBoB---E--XBB--?--X-|-----B-o-M-M-Mv
B------o?---BT-M---B-BT|TM--BBM-|E-T-|---?X-------------B-----TT-----|--?----E----|-o-M-M---TB|BEM-?-B?----T-B---|E----BT--|-T?-B?--?M-M--------|TXB||B---E--X----oBE---ME?---????-T---X----T|-|--M|-EMM
B-oB-B--T-?-|-?o--MB-X-?-EB---?--T----|B-----EM-oB-------XEE-oB--B-T-B--TB----?BTT------MBM--MM-B-?-??---B----Eo---B?|E-MX-|-B?----|-----?-?------------T-TT-|----E|---?MME---TB-B--E-M--B-B-B----?B--B-
T--------B-E-E--E----|-E-B-T--BX-----BMMo||?--BB---B?T|-E--|----B-X-X--M--MBBE--Mo-E|-B----o--------EB-|T-XT-E?-----M---o|X----B-oX?T--B-|-|--o--?|-o|-MM-Mo-E--?--?M-MM---T---X--|----M---M--E---B----T
|-B-B--?|--MMM-E--B-B-X------M---||--M--|--B-M--?--XTX?-?M---B-|-B--|--ME---------TB-|-EMBT--B--M-TT?E-T-B--T|--T||--|BMM|M|?--B?---B---B-E---o-B|-M---|--oX?E-EMM-----MB-B--||----oo-Eo??o--------M----
?M-----E---M-EMME-----EBE?-T|MM?o-o--T-?--|XMEX|M--?-?-TXT--------?---E----ET-B-X|--|-MT-BMM--B-EE---B-BM-M---E-M-ET-|-M--B-B-Bo--?-?|----TTX?B----M-BEE-XBTM-o?E-M-|--?------oE?--M--E-ooB-Bo--XMT----M
E---X|-|B----BTB|-BE-|--E---|--E--?B----X-------||-?--??--T--|-?-B-|-T|E---B-?M-o-?B?----M-----E?MT|----MM----B--T-T--T----X-|E--B-B-MB-----E--MT?------M-----M-B-B---EB-----E-B--||oT---?M-----||?-T--|
mT-|B-EMM--|MME--??---B-o-T-B-B-?--------BTM---X--o?-M--??o--B--T----BE----|M-B?-M--?EE-o-M|oB-B?E--MM-B?---|--||--XE--E-o-M--B--T?|-------?-----X---|----BB-E-E--BE--M-X----BB----|M---oT-|-T-XE--B?--?
XX-X-XX---X------X--XX--XX-XXX--XX-X--X----XX-X-XX-X----XX-----X-X-X-X--XX----XX-X---X--XXX-X--X--X--X-XXXXX-X----X----XXX---XX---X-X-----X--X---XX-X-XX-X--X---XXX-XXX--X-X-X----X--X-X-X-XX---XX---XXX
