?---T-BEXB----?-ToB--|oX-------E?|--T--?-------XM--||BB--X-|--?E-Eo-?-BEo?-Mo---o--X--B-----BM-------|-B-----||-o---T---E|---M---M-oo-|--E-EMM----M-EE?|E--M-TE-----T|B-o---E------B--|-T-EM---B--T-oo-M
ME--?------o----|---EB--|-----B||T-BXMo-ETBTBE--B-|?----E-o-------M------M----|Bo-?--M|-TTB---M----BBE|-----ET---E-E-E-TE-T---B-BB|-E--E-E-?BXB----E|MT---TM---|--B----M----TE-X?E-TM--E---EB-?---|-?|o?
E--M-------E-|X-M-?o-oB-EXEB--T-?B-T---------X--E----MB---|----X-X-?--M----B-BM---XMoB--?B?---?---------TT-M||B-M---T|--?E?-|---M?B--E|B--MEB---E---B|------M----?BX?BE--?---|E---X-----?-XE-B-MTEXE---M
---M-X?T--XT---|-B--E-----B----BToo--?---|M--T-B?EB-BE-|-B-------?-T-|-B--B---o---B-E---B--XB----MMX-o---|--T--BBM|B-----TT-|---T-Eo---BB|--XX--XT--------|------------MBo--E--M--BB----EB-----T---?|?-|
?-X---ET--BE--o---B-X--M|M-BE---||-X----X---T--X------?-oB---B-MM-T--B-T-M-|-Bo-E----o--E-XTB?X-|-----M-BB-MT----M-B---T--E--B----MM-X---?|--o?-------B-?M|-X||--M---M---ME--BE--M-ToT--|M|-To--B-B|B--X
TBoMB--EB---M--E-B-T?--?--B------o---T-E-X-T|E---|M-E-|-B----------?MT-X-E-BM--T|XB--T-T---?--T---?-T--?--B-M-B-B---X-|MTT-TE-BB-E-T----------ET---T|--B-??---oM-|----|E---TB-B-?------E--------EM|----B
M?--X-----BMT?---|||--M--|-?X---EBT-??oM-BE----|-o--T-TT?-X--B----T-M|--o-----|--B-------B-----EE?-BMM-----B-M--------?-EEEB|o--E--E---B--BB----------------------|----?----?B|---B-TET-o--B---B-----?-E
?----X-|-----B-?MT------?--MBE----B?X-B--M|-----o----|-B---oo-B|oT-ET----Mo|?-E-?-M-XT-EB--o-|BT--E-BB------ET--BETM-ET-oBM|M-MT-X---TT-EB-B---B--E-o-E-----T-TXXE------E-o-B-TB--E--E---B-BB-|----B-M|v
X-B--M-M------|E-|o-M-----oo--|EX|----M|B--TT-T-Xo---T|-T---B--M----------B----o--X--E-TB-T-TBT---B-----T---B-?T-B--TM--EB-E-|---ME---|---BE-X--|-EoE-------?--B-TXM--TT---EXM-T|--------BEMT|---?------
M-----o-X?---MM|----XE?-B---MX-----M---|M--B-|--B-X-E-BB---o-oE-?---ET---|-?|B-T-T--M-B-Bo-----T-MB-?--E?-EBM--X-?--B-----B---T--?T--|-X-|-----M--E---|-?---E-|T|---?-T-----|MB---?T-B--X|-E---E-?-----o
o---------E--BTM--TE----|--?--o---B--TXX---TT-B-|----?----E-B----T---?--EE??B-E--|XB--EETT-B|BT-E-M----X-o--ET--B-----M--M-X|?-----B-X|--M--TM-----o---X-|B-BX--T-M|BE--E?-----T-T--X||B--------?------?
M-T-M|--T----|T--BE--B-M-o--M--T--T-----E?--TTE-ME-?------?--?-?TE---B--X-B--o-T-B----o---BM----B?--E-M-----X------BMT-EB--M-B--XB-----|EM-|-T-M?TE|------T--------M-M-X-T------B-BB-B-T-E-|??--||---|X-
TB?|-?----?---E-o--|--TB-X--o--M-|E-B---MBM--BX-BB?X-----MT?B-M|EB-TB-----TB-?M--|-XE----|?---T------oEMB-TMM-?---E-o---ME--T---E-|oo-T--M-||B-B--X|-|B--|----?------B?---BM-X-?-B-T?B--E---MTX-TEEM|B-?
BT-Bo---Mo-MoT--o-B-BMBMEB----EEX----E--B-?--XT-EM--T-------------|E?-M?oT|?XB--M?--?-|----o-MB-----BE-M--o--o--E-|T-E-M-MX-|E--|?|----T|M--T-E-T?|---E--?M--M|T---||-----?---TME-B-----MB--?----E-|-BTB
m-MT-M-----EB---MB-E|T--T?--o----M--B----X--o---BT-TT-|--M--B-----T---o-----B--B---TB--BB-?-|----E-?--||-ET---ME-EM-?--?-MMM-|E-TT--|-BE-?-?-B--|--EB-Bo-TM-E----ET-oB-X-TB-----T-----E--|---T-----M-o-T
X-XXXXX-XXX-X-XX-XX--X--XX--X-XX--X--X----XX--X-XX--X--XX--X--XX---XX-XX-X-XX-------XX-X-------XXX-XX--X-X-----X-XXX-XX---XXX-XX--XXXX-X---X-----XXX-XXX-------X-X-----X-XXX--XX-X--XXXXX--XXX-----XX-XX
