X---B|-|-E----M------ToXE---o--T--TT-T--X---TE--|?M-BT-T--|--MoEB-E--|-----MX-------T-M--X--|-o--?--|--T------?M|-ME?MTM-BB-TT--E-MoEX?XX---BEE?---?o-E-|-M|-?E-X------oTo?-T-----M----E|-ETB--X--XB?-EB
EXE--?|T-X-M|--?o-T----|--|-T---TM-BT-----BM--------T-----EB?--?-XEooX-MT-||----|XBM|?|o--|ME-----E-T-oM-||TM--E-E-B?----B-|M------MoE-|-|----?-----X-|---o-BM---o--B|-T---E?---||----XT--o-X-ooM|-M--M?
B--E---------XE-o--?-oB-TB-|----Mo-M-TX|BX--?--o??---M---oo--EM-T|?--T-B-ETB-|B---E-|-X---M-----?---X-M-?-??--?B-oM-X-o-ME--BT-B--MEo-Eoo-|M--X-o----TX---oT-XM?E--?oo--E----X-|---BM--?-BX-o--|-?-?B--?
|---|X-?o--XMBBoX--T?-------X------M|-EB-B-MB---E-o||-T-|-?--?|EE-B?----XEM|X--X?--?|Bo-X?-----M?-T?-BT--?--T?EBo-------oooB-T-|---|-|-M?--|-o---?o-o---B---|B-To---|--X-?T-XoE-|o-oM--B---?----?ToB--|B
TBX--?-E---o----MM-T--X?-EB-oB-|-XX|-M-?|----To-B?E?--|--o-o----------E-T-?----?--?o--------T------TM?ET-T------X-EX|-|EM--M-T--|E-------T---|E-X-?M---T-----X|B|E------E---BT---M-------MoT-TB---?-?-?T
B-|M|-T??------E---------?---X--?X-|B?------o?B--E|||---X--|-MB-|-T---------B-X----M---?-|o?-X-----BE---X---o---T--B--|-|E-M----E-X------XT|oBX?-XX-E|TEM-B-------o--||-|----M---?M--?-To---oo|Mo--M|T?T
-o-----X|-------|X-----|-B-?--|-|X-B-|-----E-------T--?--B?EM---oo?-??---|----M|-?-----X---XB------EX---o-?-T---T?XT-------X-|--T-E-TEEE--BBoo----M-T-M|?--?M--X?-BEE---M----|X----M----|MX--X|M-o-----X
B-B-M-|-o-B|-|-E-?o--|T---M-|-XM-E--|---EE--X-----X-----oT-E-T---B-----M------X---EMT-?------BEEB---EX-E---|-Eo----|X------?---?XB|--BEX--E-B--?E-BM---?E-M----?------X-B---B-B--|--o--MX-oT---MXTX-T--v
|--||MT-|o-?---?X-Bo|?B|B-TE---o--------oE---BT-oM-----X----|-o-o-X--XTT-M?E?---XXX-T---M---E---XT---EBE--TEX----M-T-B|B-||M----EMM-X?---|--T-XXE----X--MXXTX--T-E---M-X---T-TE--B--o--oX--X-o------B-??
---M-|-oo--oT-BE-|B-B---???-B?-M--?-XB--B-BE--|ME--T----|------|-oB-----M----?-E--BXM|-EBX-B|-M|--BM-EETT----|-X---E|-XTX-M--M|--E-E-o|XT---|B--X--|-E-|-oM---o-E||--------Mo--M-E----XX?o-MX|B--T--T--B
?--E|-----?M-T--T|-M?B-|-?-oT------B--X--|-----M----B--X-E-M---|--M-----M-|?-M-----T-X-X-|XoXM-EEo----B-X|-?X----E---M--BE|M--------?--?o-B|o--T-----o------o--o-----oX-B-------MoBMT-M--o?--BX-|M--?X-M
BEo?|E----E--E?T?|--T-----M--EETB-T-|----EXo--B--T--Eo---o------X---E---XMEBBE-BB-E------X---?--BEEX-BX|--X--E----|-T-B-T-o----M|-EToo---?BX-BMXM-||--E-T-X---T-T---------E-B-MB----X|--Bo|-B?--M??--M-E
XM--XT---?-B-||-T-o-------|-------------?---B-TM---XoXTB--ToEE-TM---?o-BEB--BXB----T-EBM----M---X-E---T-M---o-E-TX-|--|-----------E?|?ETB-?-o?X-BE-MB-----X?----|-TM-------o-X-----?------|B---o-B-?T-TT
?Eo--E?--XB---TM-X--o-T-|----B--Mo-B--M---TX-MM-MT----T-?M-?-TM--X?-o?---MBEMB|o--o--|?-T-----E--|Eo-EXT-X---T-T?T--o-EEM------o-MXE----B-|XX|?---M-X---E------o-M----?B?-oE?-XE---Bo-M-o-oX-B---TM-E--B
mE-EX-M-ME---B-XT||T-?-|--|---E-XET--||----ET-M--M-M---TE--XE-B---T-M-T-|B---?E--|?B-X--Mo-M|--X|T-M|MB--?o-??-T-|---T--EX?-TET-?|-T-XMM-MToE---E-To--T--o--MT?---XX|MM--?-------|-o--B-TM----|B?--?-?-X
XXXXXXXXXXXXXXXXXXXXXXXXXXXXXXXXXXXXXXXXXXXXXXXXXXXXXXXXXXXXXXXXXXXXXXXXXXXXXXXXXXXXXXXXXXXXXXXXXXXXXXXXXXXXXXXXXXXXXXXXXXXXXXXXXXXXXXXXXXXXXXXXXXXXXXXXXXXXXXXXXXXXXXXXXXXXXXXXXXXXXXXXXXXXXXXXXXXXXXXX
