|---o--MBT-BoB?o-T---|MM--B?-E|T-o---?oTT--|-|X--XX--M-To-T---E----T------E|-o----?o----?-|-o-----E--?-?|T-o-----E-MMEoE?-oT-----||-M------T--??---T-X--B-T-|ooXEEBE-Bo--ToXM-T--T-T-T-TT|TE---o-|-XT--X
E---T----?T--?T----o?-E-??-X?--|-----|X-|E-M--------E-|XMBB?oB-----EEM-B|Mo---X--|--E----?--------|XX-X?B-BTB---BB---TXEoX?Bo--|oo--M?T----o---?--E---X----X-EET-|-?|--XEBo---E||B-T--B---oEM-T---M--T-M
M-?---|-------?|--o-M--E?T---M----oM---|B--E--B?---ET?-----B---E-|--TMMM-o-?E--M--o|---TX-?X-E-----oX--X-||-B--M?--|--X-?-ME-|------?T-----T?-X---?----?---M--|--M--M--EM-M--X--XT?-X|--|---MT|---E---BE
T|X-----XBBEM-oX-?-XT|B?B-|----------?-E----oTM--BT-E?-M--M---B---E-XEM-?---M|X-?-ooEX---E?BXB-B|?----T?MT?---?-B-B-Bo-MM-X--B|-B-|EM--ET--|o-E--M-T-M-E--?--XBoo--MB--XE-X?----M--To----T------X-MM--oB
Bo-X-M-||oo|?|-?----X|Xo||----M--o-|-o-X-T-----o---X----?-o------|E----E--X-|E-o|-|---BTEE--T|-|-E--EM---?o----------BoTXo-|Mo--M-|-MM----?-|B-ME--o--T---------|--X---------X|--M--To----M---|-EEE--oTM
-E-|--B----T-X-----MX------??-|XX--|--M----Xo-X||-B----T|o--oo-XE-X---M---X--T|M--Mo|T-M-??-X--TBTE-----E---M-MT-B?|-o-|-Mo?XBE--|-o--To-|-------XEMB---T--T-?-oTB-TXX----M---|o?---M-?--B-------M---||T
T-----E-------X--MB-?---BBMo---EE-E|Mo--o---XTM-XB-T|?-B---------MT----B--M-?-ooE-XTBT?BE--M?X-----E----o-?-----E|o---X|M-------X-|TB--EBB-X-B-oM-B-o-|--o-XoE-o-T---M-X?o?E?o-M----o---T?oo-|--B--T--ET
|-X-----?-?--EBMB---|-EX--BXT|-M--T--E-MBE---?-XB--M--?----B----o---|--|T-B----T?-ME-M--o-o----T-?TXX---?Xo--------oo--MoB-E?-----|-?--ToE-|?---T----E--o---?oB---XMM--E---o--X-M-?o-X--B--|-?--T||?--Mv
?--M---o--XXo--o-TX----EXB--XM-XB-o---oo--?-oT--M?----T----MT||||-----?-----E--T------?X--------T-o-|--Eo---E--EToTB-X-?X-|-Eo---T--B-?T--XX?-M--X-Bo-o-oX??oo-B--BT-E---BM-o-----X--MM-----o-M-?---XMT|
o-?MXo-|--TE---X----o---o----EX---ET--XX?o--|--Mo?-----TT--XT--|-X--T--X--|-M-||-X?T-MTX|M---|-oX-TMEoM?o--|oT|--|-E-M---|----T------||---E-|-T---oo---E?|-X--B-o-T|?-oTT-T-?----?--oEM--o--|---o---T-o|
To--M-E--ETE--B|----------TMBo-Eo--MME---oT-oE?X|---|-TMTME---T---E?--o?---?----o---oB-M-o--M--?-----X||BT--B-B--oXXB|?-M-?--X-----o--X---?|T-|T--?--XB--Eo--B-?|--M-BT---T--M-X--Mo----?----X------oT-?
o-B-?T-Xo-o?T------|----EXB-T?--EE--o-X---E?-ETTB--To?---|-o--B?----X?--T----X-X---|o---o|------o?---|B|XE--T-|-BB?---T--MB--------E|-ToX---?--|B-BEoX-------XE--oM-?EMT---?|-EBTB-E-|--B-B----?-X--XMXX
B-MM-?----B---------ME--|--??oX---X-XE-X--EBT|-----T-X|---oo-----To-?Eo-E?--TX---|-?---X--BX--|----|X---?Mo---B---XX-X---T?X-BME|-E-o----|--?E---|??X--M-X-----B-T--?o?-|M--X----B---oT-T|X----X-BB?E-TE
M-MM---E-|-|--E?B-B-|?B----X---X---BX-oX----B-----|||--?-?-?-BX-M--E-XE--X|-?MXX--TBo-o|-----?-MB-B|-T||?-E--oB--BX-|-M--oX---E------?T-?-oM--o----?X-M--?----?--------T-XX----o??--o-?---o-|XBM--T-??-?
mX-TEM-----X-B---X-M-T---B--XX?TX|-|-X--|-----M-o--|-X-oo-?-|--E--------o-BB-T-ME-|----T-----|-X--??M-ME-BEM-?--EEoTMMXB-B?-T-T--------|o-B-X--X-----XT--oT--|?--|--MX-oBX-M?M-ooBX?-|--E-o--ETXo-|B---X
XXXXXXXXXXXXXXXXXXXXXXXXXXXXXXXXXXXXXXXXXXXXXXXXXXXXXXXXXXXXXXXXXXXXXXXXXXXXXXXXXXXXXXXXXXXXXXXXXXXXXXXXXXXXXXXXXXXXXXXXXXXXXXXXXXXXXXXXXXXXXXXXXXXXXXXXXXXXXXXXXXXXXXXXXXXXXXXXXXXXXXXXXXXXXXXXXXXXXXXX
