o-o----TX--E----------?T-|M-B------|ME---o-?E--B-XoMoE-----XoTEoEB----B|?o--X-T----T-X-T-T--E----?-----M-B|E-E----E--?-----|X----|B?---X--|-?T-T--EB-----?---M|E-XX----XEX--EoB-X----|--B-B-T---BBBT-TB-
oM--B----MXTT--------?EET|---?BE----?-B|-TT?B-oBBo--BB----B---B-X-B--B--T--EEM------M--MT-E--ET------MEo---o?-X|-M---B-B-M---T---------M-X|--E------E---B---?-?-T--?--B-T-M---T-TB--?-B?-B--M-|---E---BT
-B--B--o---|T-|--BM----?B---?---?---M-BBX-BX-o?---B--?-oX-?--|-X--?|-?---B?--o----MoX--To-?TB-B----M-T-X-E--B--X--M--B--E-B-BE--MTB-BMo--X-----E-o----T-|EX-|T--o---M-o|--E?---E-T---|M------oBB--M--MTM
|---B-----M----EMB--EB---E--?--M-B-X-----?-E-----|---|--T-TB-?XB-?|TMM----B--E-|--E-?|---||----MM--TB----?--XB|--M--|---|B-|--MTM-B?|XM-----|--?-T-BX--E-B---BBE?--B-TEMo-|-|?T-TMXM-B--B--??B?-TB?----?
MMM-o-E------E-B----?E-----M------------B-MEB--------M-B---T-B--X-|-T----X?B-|--o-o--M|B-EMX-TE-----MTM-B|-o--B--?MTM|-X----M---X------X?M----|--B-T---BM-B---?-E-X--X----X---?-??---TB|--E----T--B----o
X-T-|-B---X-B|-?-B?-?---T|TT?BTEM?----E?-ET-----|--MT--ME--X-----M----|??---X-Bo-E-------X---M?|-----MM?---T-B-ET|B--M?-E-B---??----?B-EB??E---o--|B--ME-X--B-|?MB----XBB------B----|?---|--------M-M-|E
o-BB---BT-E--B-?---B---EB---E--E-----B--?M--|------E--B---B?B---oB?E-|-EB-----oE-X?M---XE-BT--oT?--M-E-M---BT?EBT-B-M-|?-E------?o----X-BB--||--M|o?B-TTBE-BTBT-X?B-|----EM-----?--------TEE?T|o-----B-M
|E--?M-|?-BB-|XM---BBE|BB-M?-E-||B|-|----M---?E------|----E----B-?B---E--M---TBE---X--Mo----MMEo-|----X?MoTo---X---oooB-?---E|TE-----oo--T-----B?M-B-?----|MBE?TEB--------B-?M-?EM|--|-oEB-E-TB|---|X--v
TB--B----B|T|M----?----?T?-B-----E------B---TE--?-------MEBBMB----XX---oB--M-X-|--BE--M|T---TB--MT|-----?----|-----?E----oB-E-E--M??E----B-M-B---o?-T---o?T--|----MB---B-B|-B----?------|--EBMo------M-?
E--M-----?--|X---?E-B--?-oB---MoB-TT------B--B--EE---TM-B-B-T---T-??B|E--B-------oM|--oE-TT-??---E--------------?-------X--Mo|oM-------M------E|T-----B--T-----X-XE------|------------M-B|------M-E---?T
MB----??--|-T------|B--E|---TB------|--|---?B-?B--TX--T-T-XE----M--M-|------E---XB|ET-M-----B--B-EEM-B||E-E|--?-------MX--B--?-X-o--?T|B--?---|--TMB-?-E-X|?-o?--M------E-MBXEB|-?-TM---o---B---M-T-EE-B
M-B--?-|---M---||o-?BX|-E-|-T---ET-B-EB-E--B?oBE|EB-BTBE-----------?B-MM---TB-o-?B--B--M-E|-|X-B--MM-XEBo-B---|o---B|?o-E--TM---|---?EB---?-----TE--EB---B---E-BE----XT-|-----?M--|--MTBM------oXB--?T?M
|---EM-|-|-M-E-M--oo|T-|Xo?--M---|X-E--MoB-B-X-X--E-----?M---B?o----XB--o?B??To----|--?T-M?X-?-B-?---M-TM--|---M--??--------|-BB-X-o-MB|B|-M|-----M---BM---------T---E---|----o---?MB-E-o?|---E?-BMMT-||
oBE-|------oE--TM--E-T-B--------oEBX-Bo--T---B|-?T--------?E-|-??---?-?-T--M-M|TM|-X|-TM|---Bo?---|T---|------|-M-BB|B|--M-B-o?--M-E-o--TE|E--?-BBB-B-----T?|--|-BMB-?-MBoE?-|----M-??-----B-o------M-MT
m----X----ME--BE?-?------T----T|M--E-E-X-M--Bo?-B|-X-X|EB---MB-MB---T--?-X-B-?--B---E-T--oB-E--X-|X--M---B-------B-MX-M-?----E----B--B-o-|?-?M-M----|----XX-------TT?|X-?-oB|-?----M-B-E--|------B-----M
X-X-XX--XX-XX--X----XX--XXX-X-X-X--XX----X--X--X---XX--XX-X-XX-X-XX-XXX-X-XXXX---XX-----X--XX-XX-X--X--X-XX--X-X---X----XX-X---XXXXXXX-X--XX-XXXX-X---X-----X---X---XXXXXX-XX-XXX--XXXX--XX-------XX-XXX
