MM|-TX-EM-EBo-o--EE-X|?|X|--X|E|-----XM----BE-M--T-??--|--??o----T|-M---B----XXoX?----M?---X---M----E?-B--M--|M-----o---EoB--T-o-X|T--E-oB-|--T---E?TM----ooX-oXT--?MM?--B-X--T-M?--o?-|--M---MX-?|B-oEM
-E-----ME---B-?----TX--B-M-B-ET-o--o-------oE--o-E--o----?|------|TM-E-T-|?----X|B?-E--|-|oB------|-B-?T-oM--EB?-BoT-T---o|---T-BX--oX--X-o-||-------B-----T----Mo--EoTT--X-X--oo-||-EM?--Mo----?B----EM
BE---?E--|B?-----o--TMB-o----E-|-o|Xoo-?-M-TXE----XM--?-o-E-M?--E-BX-||-EMX-----oEE---|BB--T-----?--T--M--?M-Eo--T-X----TT|B-----MBXBXE-B---Eo--o-TT--BB--MX-B--T-M-?-E---|-?-----?M--o-|-M----o----X-?B
|X--?T|-MT--o-E-E----|o--BT-B--EEMT--?-?Eoo-?-BX?-M--EXE?X-?-?---EX--XE-||XXX-X---|-|-o?X|--E--oo---ME-T|B?E-----|B--E----X-o--o--X----T?o|-----M|T-------TBo----MBo-?-T--oET---TTX-TT-B?-???oMX--M-X-ME
M?-----o-B---||-?XE--o-?----BT--?-----B-B-|--E--XMX--BBE---TXX--BM-o?-ooo-ETT-X----oT-?o---TT-?EXo---?E--|-EB-M-Xo|----?-T--o-M-?--X-M--?--oTo-M--B?T?--M-E---XB-B---?E---MEEB-Mo----o--M-M|T--TBBXXE-T?
o|---TX|--|T--BXM--E-B|--XT---?oXB-MX-T------T-|--T-E|XT--M----oXBo-----------o--EBB----B---o-T---------?TT---EXBE-o|-o?o-MBE|o--X--BEX?-o-ETX-?-T|M----?M---MB---XM--Mo-XM-XTB-T--o-----?--o--oB-o--M-|
XoE---?E-E--M----o|-?TX-oX--Xo-oEXX-XX-X-o|-M-o-o-MX-T-B--?T|M---M-BT--X--??o--|----EB-TT--|-BX-B-o-?-?--MoXBM------TT|E--|T------o?--?--T-T-TEEM-T-|ToM-EX-M-?-o---E--?BEX-?---B-B--E---|E-B--BX-B|---|
-|o?---BX|--BXM-TE---oT-X----o-?---B---E-|--?---o----M-----TBEBB--X-?-Bo-?M-T-?X----M-?-----ET--------T-oM-X?-E-----X--X---M---------M------|-X--|-T--T-BT---To----o|o-E|X?-To?-----E--------B---B-----v
oo--T-M--------E|o---X----X---MX?T----M---?MMX-?M-B--B-B-?----XXM-------X-?E---BX--|--?MX-X??M--|-o--oX-E-B|-?-|TX------T---X-X---?----T-X-E-?B--E-oMTX|-BB---M----E|ooTo----M-|-X-T--T----?-Eoo--EB--XT
M--|X-----MXTB-E---X----X-B-o|-E-E---|-M--T||-----M?B-XT|o--B||--oX---E--To---|---M?-E-X-|-o--|---E-------o-XT-o?B-o---MX-E--|-----B------?--E--?--BX|?-M--E-XME---TE|-X----|X-X-E-?TE-?-EEo-XTEX-|T--XT
o-?E-|T-ooXE-o---E?|-T----|--ET---|EMEMM?--B--T-|-?--B?-oB--E|X--|---T--|EBBB-M-E----Eo--T-T|?------o-??-X-|---T-o-?T-oB-XX?----M-M-o--o--M-XE--|--X---BBM----|--E--To---|?-o-B--M-----?-oM|-----B-|-X?-
B-XM---B----------T-B-B-----MEo---?---?-B-M--E--B-|??M-X---X--?|-----o--o-----TE-T----ooM---?---oX----?EE-----MT-----TT?--o--?X?XX-B-oEE?--M--Eo---BM-----|--X---TMB--XE--?-------------X--XX--o-|----B-
-X-TBE?-X----||-?------BB-E--TT---B-?-M|MB---M?-|--X---Mo-ooX---|M?--?-MTTT?B?ET----B-M-|?||-B----Bo|-oM--MTM?o-------------|T-----To-E-----?--||-XTB-o-|-----M-XoE--To-?-oo----M-----TB----|ME?BM--M|-?
TBB---X-ET--?--o--X--XX|XX---M--MM--EB-oB-----X---|--T-M--o------M-?EM--Eo----oo--BT-BE--|-|oBE-BM-EMT-M-|---oM|----oBXX?|B-----|--o-||X-M|--|?-E-|E-BEoo?----?o-M-X-T-EXMo--E|ME|X--o-M---?-?----|-EBMT
m?---M--M--?T|T-----o------TT-o?X?-MX-----EToX|o?MTX-EEX|-----E--M--M-B?o------B--X--------EE-?--B-T--X--|---X-B-T-|o--X--B--M|o|X|X-?-T---o-o-TT-X?---T-B?----B-|---?--T---|o----M-B--BT-----?X----MBXX
XXXXXXXXXXXXXXXXXXXXXXXXXXXXXXXXXXXXXXXXXXXXXXXXXXXXXXXXXXXXXXXXXXXXXXXXXXXXXXXXXXXXXXXXXXXXXXXXXXXXXXXXXXXXXXXXXXXXXXXXXXXXXXXXXXXXXXXXXXXXXXXXXXXXXXXXXXXXXXXXXXXXXXXXXXXXXXXXXXXXXXXXXXXXXXXXXXXXXXXX
