T-TEM-B---B-?X-----Boo-BXX--?E-||TXE-?------X|TEB-?-|--?oo-?--B-T--M--MT-B-X-XX-|----E--|--Eoo-ME-------M--oo-M-----o---o|MM-T?---|-T?--oMX-??M?------T--TM-----BB-o-|-T-M--?--BX-BXX--M?M----|-XT--X--X
E-----T--o--|----T--M--|M--MB|-T--M-o-o-BE-----|TB--?--?BB-B-B----o-o-|-E?T?--M?M-MB-M|MT-XM-----EBM-B-----T--B|X---X--EE-T-X-E?-X-T-X-EE----?X-E-------?E-XTX|TB?X--oXBB-oXM--BXo-E--E|---E-Xo--X--?BB-
?X-BE-o--?|TE-?----Xo---------EX---|?-X---E?ET?XT--TBE?--?|B|X||-|----X?B?-B?--B-MB----TMoT------|-T----|-?--?-?-|-T-ToX-|------------E----EX-|?BoM|---BE?B--?-|-E-------M-?-B--E----?X--B-B-M---XE|?M-?
----EB--BB-MX--BBEB--|-T?--|T-E---T-|--M-|E-B-----MBX|-EBM--|--|?--M---B-E--T??-M--E--o---E-B---|-?-EB---|MM----|oB-----E-EM|--EE-?|T-E---TX-X---B------|--T-?-----M-T---BT---X-B------E------o-B---|E|E
B-B-BB---M-T-X-?--E?-----||--B-?---E-XB--|---BE-MM-T----X-------EBM-oX---------MB--?o--|T-TME------|-o?--T-|-B-----o|---MB-T-XEEoT-Bo-TBTB---MooE--X-X---------TX--|---?-B--|X?B--B--X-E--TBB-o-----EE-B
T-E-oB--B--E---B-T-|E-XBo-?---E-----B---T-BT--M?---X-X---?||-|--T--?B-E|-X-X--BE---B--XMMoX---|--|XT|--------|-XoB-?|MMB-T-B-B|BMo-M?M-|M-T-E-o-|B---|?B--BXM--B-Bo-E--T-X----Xo--B-EX--E-E---??E------X
|M-|-|-|T---EX--TT-MoEB-|?o-------?-|M--o--||T-?BE-T?--?-?-?---oX-BM----?E-?--B|E-B---E-B--TB--T--M-?-|EX----oBXM--X--ME-?-|--EBo----B---M-ooT--MM-E?-MBBX-?---|MX|--EBM-----BBM---MT|T-|--|--B--B-----X
TE-EB-BM---------?X--?M--E?--T--T----B--B----M-X-|M|MX-B?-|XE--E---B---X--X---||?BXTB-BE-X-BToB----o?oT--BM--T|---BE-B--T----M-M-??----B---B------|M??|--TEMB--BB|o-MT||-|B--B?------?--B?----X-X-B?---v
M-----BX-B?oX?-M-oT----?B------T-M-E-BT--E-o----M-o--T------B-B-TT?-B-----E-|-E---E?-EBE----T-?B-|?M------E-?E---X-Eo--X?TM-X----B--BE-M--?X--?--ooBE-----MMX?---TT-------M---M--B----E-----------TT---?
---|-B--B-M----E?TM------T----?-?TBT---?M---o-X-TX---?E--EB--B-EXT-T---M---|-BTME-o-|BBT-E-?-MM---|-|-E-X--T--?--?-M------M-X--MEM--M-BE-?-XT-EM-oX--?--?T---E-?--o?-?--oB---?|M?--TX-?MMB|-T---TT-T---E
M-----M--B------B?-|--?-|M----T-?-|---EM-MoT-|--?--XM-B?T-B-T-BX--E?---T-EB---BX---?XTM-EM?-----BoT-X-------E---XTM||-------XBE--BTE|-|BM-|-Eo-BX-??E-?T--BET----o?|X--|--XBM?-?--M---BT-T|?MB-oMM---BEB
----o-o--?-E-|----o-XT-|-MX--B--|-M--E-B?--E--T--|---B--T---BX--|---BE-E--o--E--TBTT--BM-------XT----M----XB---?XB?o-----B-B-----------B---XB---M-MMEBB--XTX?M---To-T-EX---|-B-?E-M--X----|EM-EM-?Eo-o-T
--?|B-?ME?E-TEB|--o-X--|-T|?-o?M-B----M----|MB--BTX---o-?||----XEB-oB-E||----|B-M--M-XT-----?T--M--MBMB---X-TM---M--MM|oXB-XB|-BM-X-?--XME-?--B----T---?E|---M-BX-----E-oXB-?B-TX-o--BB------B------?E|T
M-X-X--?---B----T--T-||-----------E---|EE-BX-M-||-E-E-X-o|T--MBEXB----B---?o----B-|E-|-X----MTE--X|o||--o---MB-B--Eo-TEB----?BEMT--|TM-----|B-E--X-E|--X--B---B-----MB-oE-M-----ME---X--|B?o?------B-ToX
mBTB-BM---BM-|-||--E-------MBX---|---oX-|EB-M-----------B--B-B--|??---BTB||-----Bo--E---X-BTT|----XoE--B-----|--T-T--T-?o|X--------B--XT----XE-?-ME|--------?--||--T-B--B-EM-E-MTo|--B-----X|---XT---E-M
Xo---oooo--o-o---ooooo--o-o----ooo--o-o-o--o--oo--ooo--o-oooooo--o-ooo---oo-o-o-o-----oooo-oooo---o--oo---o-o-oooo-oo-oo-o--o--o--o---o--oo-ooooo-o--o-oo-oo------o----oo---oo--o-o--oo---o-oo-o--oo---X
