XM-TX|----B--Eo-EM--?-B-E--B---T--o----?--B-B--?-----E?|T---oMX--MTT---B-E-----E---M-B-?B?-E----|X-B-E---MET--T?E-M--T--T-ET---TX?---XE--T-----T-B-oX-M-ME---?MX?-E?XoM?--ME--|--E-X---|||--MX-XX---X?M-
T--T-|T---|o-B---E-MT-B---ET-T|B-??--|B-BXB-X-BB---TBoB-?MB-MX--T---T--B---B--XT-MX-|--?-B---B?--B-MT--BM----M---T-|o-B|oB--B------T-M-BM---?-?--BT---T--|?ME---|-M-?Bo--XTM---|-XE-oX-E--Bo-B-M|--X---T
X--?|------TM-E?E-X--|--BXTE--oB--M--M--B----T---oMB-B-B-T-------?--M-----?----|-BMB--o-M-|--M|-o--M----T-B-----M--------EBB-----B---------B-----X-|---|--E--T-o---------?M-T-E-M-E--??---BE--||----TEB|
o-----?-M-?-TB-?--?-------?Bo---M-B-|-E---?---?T|-E-BT?-T--X----|----?-B-?B-M----E--M-E---E-|?-B--E---?E--|--BBB-X----EE-BT--E--?|------EE|TE------E--------E----E--|XT-E-----T---T---T--XM-T--|-XBB--BX
X--|-?-|-?BB-B-E--oMBB?MM---T-M--T-------M--B---B-T------E----?-----M|B------|T-MX-------M--TB---?--|-T??----------X--T?TBT--o-ME-----EE|-?-BTMT-To--MBB----|?-------E-T--oo||TX--E-o--?-M-|-----|T---TM
|--?T|-XB-E?ToT--M----oM-?---TMTBBB----EB-|M-T-|-------X-----oBE-B---|X--M-T-E-B---?--?To-E--?BB--?-|B?---TM---MT--|-E?M---E------B----T---M--B-MX--|-E--M--?T|-?B--B-X----TT?-M--E--T--TBX---E--MBM---M
--??MEBE--TBEB-----?B?--BB--X-----o---TBT-BM-----B-T-?-T-?-------oB--|------|o----X--TE---|BB-E--MBB---|T---B--EBMME-T---Eo|?--TX-?-------EM--XTEM-------BX-?|--T-|B---TTTB---?MM--TM---X--------|?-|BBT
o---EM---T|---B-o-?ME-M-o-|B-M--o--BM--|E?T?-BB--B-T----BBMBM-B--?MT-TE-o-B---oE-B-EE-BB-M--E-B?----E?TM-M-M--|?-----TT---B----|BMTTMXo?T----E--?---------|---BTT-EMBXT--BX?----?XX-T-E-E-E|M-B---||-M-v
o-o--|XT--?TE?X-X-?---ET----E-|TBB-?----oB----TTBB??-----T--B-EBM-----M?--X?T-X----X?ME|X?-Bo--T--METM-B-B-oT?--B|--T-X-|?--E-|T-XM-|M--TB-------?---E-----E--B---B--|-o---E-EMB|B--X--X-----XB-E----oT?
oT|-X-----M---E-o---|--------TB----|---M--X--?--M-M--E-|----MM--?---oT---X--E---X--|TX--E---T---T------E---TB--T---B-----?--E-BE--T--B-M-XB---|----o--oE--M---BX--X--M-TB|-----o-BM--T----oTE-|M--BE|?-M
?--T---|-M--M|-M-E-T?---?---B-|-T---o--T-B--X-E---B-||o-----|X-MXB-MB-Mo--?|-X-B-----M--TT|X--o--M-EE-----?-----BE---EBM-B?|o---EBB?---T?|?Eo--|B--ET?M--B--E-M--Xo-?-ET-----T-MB-T|E---BM---EE?B?-|---?
ooME---M---B--EBo---?-EoT----------?-X|-T--M?-|-B---XT-X--BE-|?---EEB--E----T----BB-BoM-MB-BTB-BTX-X-----T-EEX--B---T----M---X---E-EM---M?----M--E-----E|-??--XT----M-|-EM--|B-o|oM--M---?--TBB|-TE--?T?
Eo----Xo?---B--E--------E|-EB------X----ME-----?-M---B-E-?--BM-----M?--TMME-BT-----B-TTB----?---M---T------B-----EB----M-B-B?--B---?--?-----B-E---B-T-E-?---|EM---|--M?---?-|MT--EM------|-----EB---E--M
E-B--E---o-----EB-|BXE-M--TM--E---E----BT-B|-M--|-|--|E---T---oM-BX--|--|X-X--|-E---T--X-----T--??-o|oE--M-BB-M--M--BM-B----??TB------BT--B-B----o-E--M---?--T-T-----E?T-B---TE--oX--o|--|?--B----o--EEX
m--|-|---B--?------?-B--?---X-|T?E--|-|--|E------BM--E---MT--o--?M-M|---o--|MB-B-EE-----|--B---X---BE--B--|-EB--?-M|--M----------E-----M-----T-?-?-------E----E-----XB---?T-|X|-M|EE--|B-E?--E-----T-MB?
XX-X-XXXX-XXXXXX-X----XX---XXXXXX-XXXX------X-----XX-XX-XXXXX--X-X--X-X-XXX-X-X-X-XXX--X-X--X---X----XXXXX-----XX-XXXXX-XX-X-----XX-X--XX-XXX---XX-XX---X-XX-X--XX------XXX-XXX----XXXX--X-X-X-X-XX--X-X
