E---|T--?--X-o-B---T--MM----EX-|oT-------?-?B------?-B|Mo-T?-E-X--X?-E---E-M-?B--T--o-----M|o-B--|-X----|?M-?-|-T-T--TM-Mo-EoTB--T--Eo----------M---|--------o-E?--E----?-XXE-----M?--EM---|--TT-M---?X|
|-?---E-T?--B--T?---T-XE--T---EX-BXo|------EX-B-M--MTM--TE----------EoX|X-T-o-EM?|Mo----|-----o-B?-T??-B-B-X---M-?M-B--X--EB|MX-M|-------?EM--E-E--o-?X-X---BB?B?--M---TBXo--X-?|--------??--M--|---M|T?
?--X----|----|-----oEoMo--TE-M---X--EM?|--M-??-BE--T-?----TT--|--o-E--|TEBX-T----BT|X-BX---?|----E|-----T|--X--EX--|---?-o--|--|--TMBToTM-TBE|-|X--|B----B--M?o---|EMoM-----MT|X-MB?|---EBET--BXB--E-M-X
X-TM------TT-----B-?-----T-TXoT-To-|-X--X--o-TTo-BE------T-B--|-o-X-oB-?-E-T--T-|XXX|M-------oE---M-o|XX-XooX-T-B?E-X------?------M------oE-B---TTBE--BT|-|----|-oBT-E-E---X?TT-T----BMB--TM??-oMM--BB-?
o-||BB-X--T-|---------E------o--?-T--E-X--TM|-----T|-|TM-o--o--E---oME-T-|----T--MX--Xoo-?-?|---T-E--M-|M-BE---B|X--E--oT-XM-TTToEo---|-X-M|E?--T----EEo-------??-?---T--|TB-----BX---??BE-M-MT---??-T-X
|----EX--?--||--BT?|--TBX|MT--B-|ET-?-X-||-----?--|----Eo|--?T--EB---M-E-T-M-?-E-Eoo---?-TMBM--B-o-o-?--M|B---oo-|---B----|--M|M?-----o-----X-|----X-B-M--o?---|--X---M---oT-B-----o?TE-B------oB---TT-B
oXoXB---X-BEX-----T|-TXE-E|-|-M-EXBX-B--o|--E-----|?-?-T--T---o-?|BB--X?---E-?|XT---M?--B?T---E--E|o------?--E--M---X--B|-B-T-B--EXo-------oB---T-o?E-E-M-M--M?-MT?------B---X-X-XoX--?-B---?-T--EX?B-o-
M?-------T-T--E--o---E---MBoE|-B?---oMTE--B?T--|-E---X-XT--TX?-T--o-?--?--B-X--E|M?BE-T---?EM-oBT---?-o--?--E-M--|BB--?BX-o-|-oE||-----oXXB--E|----o-MM-B--EMEM--oM--X-o--?B-E----T----?-oMX--oX?--X--ov
B--TX-M--X?-oXo---|--?TTT|T--E------BEE---T|T--B-MBTX---E---o-|-E--|BEMo----M-|---X-B|---MTo-B----o----M---oB---oX--E|-|o--|---|E--MTM|-|?--X---ME--EEXE-E-----T?oE---o-M|--EEX---o-BoX--|-oo------||--?
T|Eo-?To|o|-----|-T-T-----TB----o?M?-E-|?o--B-EXTE-o--E--MX?-X-T?---TM-|MMT-|-oT|o--X--T-o-?EM-T-----oXE------------X-B-----XBX--E---B|-o-----oT?M-|X-TXM|--M-E-B-?-BTX--o-E---T--?M--M|?MB|-M--B-o--||E
X?-X---M-------E-X-E--?-TME-o--E---E--E|---|-M-----MB--|----|-B--o-BTE-|---o|-------?--BXT---oM----T------o--?TE|-----|-X?----|-E-|---E-?----T--?oT-BE-T-X?|--||o-?-MT-o--XE--B-----------XE-X?----E---M
X-X|TTE-oT-|--o--|-ME|M-o-------E--BB-oTX-o--X---X----B-o-o-|----E--|M-|XTXB---?-EX-oBoXBX---o---BX|EMMEE--o-BXT--o?-B|-B-o-T-Eo-X--X------?-T-?||ooB--o----------|E?MXX-?-----T-M----EBM?-BMEEoBE-B-MoE
o---T-o--M-o---|X------M|M---o---X----BEXB?TT----o-?-T--?-XT----M--X---B|T|--?--EM?T?oM---BX-----E-o-oE--X-B-?E-X-BM--oM-----Xo-BB---B-X-X-XE---|--oX|BX----X?-E-XM?--oT-|?B--o?-o-B|-|-o-XB----To--?oXB
E----|B?----B--TT--?----M-BB--ME-ME---T----M|--?-B--M?ETX--|--------B--------?----X----M-TB--T-E?----?----?--?oM--XT--X?TMEXM-?XM?X--B-?--?-TEB|--M-MMX---BX-TXB---M-----M--X---X--E-EBMToEMT---T-ME----
m-???-|-----T-oT---o?-?---|-XT?---T||X--T|--|M-o---?T---o-TX---oMo--oTE-To-------|E----|-BB----Xoo-X---E-?---B--ME--------o--E----T-oX--?E---|-BT--M-o-T-EX-----X--T--?--EM-M---BX--M?--||?-o-oEB--TEo-B
XXXXXXXXXXXXXXXXXXXXXXXXXXXXXXXXXXXXXXXXXXXXXXXXXXXXXXXXXXXXXXXXXXXXXXXXXXXXXXXXXXXXXXXXXXXXXXXXXXXXXXXXXXXXXXXXXXXXXXXXXXXXXXXXXXXXXXXXXXXXXXXXXXXXXXXXXXXXXXXXXXXXXXXXXXXXXXXXXXXXXXXXXXXXXXXXXXXXXXXX
