ME--E--BBo-E?-EXB----BB-BB-X--?-?XX-|BT-T--EB---B?-ET-M----B-E?|o-----------o---TB-?B--X---|XM-?------TXo-X-E--E---B-E----BT--|-|--X--XE-?----oo??-E----XT---TTMXT--X--Eo---X---T---oEEMXEM----XM?M--TBT
XE---o|-X-TB|-|-M--E??-E?X--ToE--X-------|T-----o-|---o---BX--E-----T----?---|--M-o-X--EMTo-----M?o-?-EE--M-ET--XXE-?-ME-E?---BB-TEBo-E-B-T?B-?E--B--E-??MoE--?--M-||---T--?-----B-TT-|---oT?--?X?---?oE
-E------T-M---M--?----?M---E-M-----X---M----M--T-|--EB-M-M--E-T------B--E---|-o---M-----|----XXo------MXE---M----T--T----B----o-o-----?-o--MB--o-?---o?|oEE?-E---T----B?--|XM-?--T--X--oM-E-------T-METX
E-TM--oMo|-TEEoE-o-BM---E|-TE------XMM-T----EE--XT-X-XBT--ET-E-X---T-T?--XX-------M-Eoo|----BME-TM-|-o-TM-B--|?---TT???-|E--M--X-X?X?M-B-BEBM--M-B-TT------E-M----?---|-TT----|-----?o-|X??---?-o-E-E-EE
-Mo----X-o-M--Bo-o--X--o|?X--|-ooEMoT-?--|-T-?BE-BE----T?---BXB--MMMB---M--X---o-B---|--X-M-ooXE---BTB-M-BX----M-EM-?-oXX-o--------XX-----XoTME-BTX--X--T-MMT-TE----o--?E?E|----X-B-TBB-|--o--|-|-T--ETT
EXMM--X?---X-B--E--X---X--B??-B-B-B----o-----B|?XT-TM|-oT--E-MB----BXoT--TB--X-?X-oE---XTB-B--M--B||X-BE------X-E--?------TBE-T--B-E---T--B?-MM--E|--B-|?----|E-|To?-T-M--ETM--M--oB------|-o-M---o--BTo
oBMMoT-E--Bo-o-E--B|BT-E-?----E?--?-------XMoE--oBM-oM-E-----EMo|---T---X---M-Mo-XMM--B-XEMM--M-||TBo-|-B-o------M-?E??------T--E-?|T-T?-B------T-?E-?--T-T--TB|-M-|-T-|T-T--|T--TMBo-MEo-o--oXE?-TM--oE
BXB----|-?--T---ME----M-o--M-oT|----oE---?o-EMX-o----ET-XME-?B--E------E?---T-Bo----?-X--B-|?-----B-T-?--?E--M|XM-----o--?-----E---|--|-EE-MM-BM|-|--oE-MEET-oM-B----BEBo-TT---|oB--|E-EE-|-XX|?---Bo-?v
B?-T---T-T-----M--M-------T---??--M----oXM-TT--M------|X-T|-o-E-?M-|M-B---M?--o-M|oM?--X|X-o-B-E--??o-E?--|B---M-B-----|--B--XB-Eo-MXXBMXET-oEo-ET-oo??X?B?X-X-B-------Bo-o-|T?T|--T-----B--|o----?-X?E-
|MXB----|ME-E-o-X---?M----?----?o-|--||M--M---o--X-MB-E--T-------?-E---o-MM--T-----X?--|----T----T--o-T-o---------M--?-?-|----X-|-oX|--TT----|T-----|-------|o-X------M-X---TTT|-|X--|-o--|E---T--X---X?
||E---T-o----B-----T--T--EEXT---MT----XMTMo--B|---?----?-o-----T?X-X----oT-?-----?B--?||?XE-o-||-T?B-TXB?-ET?-|?-?--|-BMT--E-------M--|-X---?-T-oM-------?---o---|--X--oM-|o|---|-------M----M--E---XM?o
TT??--X---X?T?-B--|-Eo--XTE?------XEEM-M?---MoBB-------?-?-----B-|--BT--Eo?X-BoT--T---E--|?--XTBo-?B--BT--TX---|-o-XXoMME--XB??T-oBB--X-?-E?oX----BT|--|-B-E-oT--o?oB--M------BT---BE|--o|-------EEoo-M-
TEX--o--o-o----|ETM--?X-ME-B|?M-X-Mo--XX?E|T-?--TB---|--T?-o--?----EE---|--E--M---BT-BM-B-o?--?-MoM-B--E-XX--X---XoM---B-X---T---X?BE---E---|?----BM-XEMM--M-?-|-|?---o---?--|MX------?E?|-?-?---?--o-EB
?ET------M--o-M--E-EX-oE---TB-X-BB|-T-To---TEE-oB--M-X-M-oB-o-BXT-------o---|--M-?-o----T?-oBo--o--|--T-o-B|-TT---T-B|-XM-|oB--X--ooX-BE-?--M--B---X--?T---E----B----To?-----M---XEXE-TE?BX---?--X-MT-M|
mBB-X---M-?-?E---o-E-B-B-B---B-E|-B---|E?Xo?M----Eo??X|o---EMME------o-|X-oEMo-M--T--T-E----|--?T-T-EME---|-B-----|?|-BM-|o---M---E-M-TX---------||?--|-X-X-EoM--o---o?EX-o|---B--o--|MX-B?-----XB-?--BE
XXXXXXXXXXXXXXXXXXXXXXXXXXXXXXXXXXXXXXXXXXXXXXXXXXXXXXXXXXXXXXXXXXXXXXXXXXXXXXXXXXXXXXXXXXXXXXXXXXXXXXXXXXXXXXXXXXXXXXXXXXXXXXXXXXXXXXXXXXXXXXXXXXXXXXXXXXXXXXXXXXXXXXXXXXXXXXXXXXXXXXXXXXXXXXXXXXXXXXXX
