B?|-|--BM-ET-M-o?B--ME--T?-M----------||--B-TX-|X-X---?X-|o-o|-X-|---E-E-|-|------E---?--XEo-??X-|-M--MoM-o---o-|--?-M-T-|--E-M-M|T|-BM-|--?M---?---------X-E-?M--o???--|-T||---E?B-MB-X-M-|EB-B-----o-B
XMoo-M?-XE---E--M?BE-o?To-|--E--M-o---?-B-oB--B---E---Bo-o-?-TM---E-------TB-|-o---?-M-?-?-----E?T--|-E--ET--?T-----|-------M--|--o-TTBX|---MBoE-TX|T--TEB---?--oX-B-?----o----------XMM|-EET|Eo-oX--T-T
T-T?----oMoM|?---T?---BT----|EBX-?--XBTTo-T-X--M----M-o-|X||-|B--XBB-??-MooBB--BB--o-B-B-TX-|X-T-?---------BX-M?--X-oTo---o-M-o----o-E?--X---|-E----B---ooo-M-----XoX----|----?-B?--Eo|E---M---|Mo?--B-E
|---TT|?----M----EMoT-?--M--XX--X?--T--T??-?--o-BTEM-T----TE---|--|--?M--|?BE--oE-TM---o|-|---?oE--o-XM--XT-X--?--B|--XB-oT-?---o-XT-ME-X--T-M-----B---|--o-TTo-E----|TE--ME----|-T-E-TX-B------E-T--o-E
M-|M-M---TEBX-E----MMo-|-?o?---B--ET-TTXTBBo-BTB--B-|----XT-----X---X-X---M----B?BB--o--X-X-B---X----|-XE-?TM-oB----TT---EMT-E-|-?-T|--------BEB--E-M-MMB?--X-oT--oM|?------TXEE-o--M--------|M------M-E
oB--M---------X-M---?o-EB--?--|-?XEX--ME-TB-?E---E--|XE?--M---|o-oMoM-----B-T--|-?--?oo---|oEE--TT-E--BM--MTT|------E---BM-E-B-ME|?B---|ooo--?--E-----o-E-XoTM---|XX--M-----?-B--T-B-X-TT|oo----BB|o-|-o
X--E-----T-TMX--o-?-MM--o-Mo?-X?-Xo---MB-----X-Eo-M--X---||----ETM----B--|T---E-T--X?-?|X-M-------|o----B?M|XT----E-|B--?--T-----oE---E--TTM---oE|T---M---|?M?-oo-E-----oET|X-E----------EX---MTTTB-o--T
o|o--o?|B-MoM------X-----B-X---T?E|T-|B?|X??----?-X--M-BX-?B-M--T----B-|--?----o-MX?|B-EoTMX---T--|---M-E-o?E----B--E-TB----o-T--o---X?o-Eo-|-Eo---TT--|---M-E?T--E-----T||-X--??|E-|?--X-T-Bo--?--B?|-v
E-o--oo-T-M|-o--|----M-E----X?-XoE-T---X----BXTBT-oB--X-----T------X?BT---X----T--o-?--?M?---B-M-Bo-XM--|E-------EE--|?|E-?XT||-Eo--oB-M|-|E----B--oB?E---X---X-?-|E|-------M|---XT--?|--------E-TB---oE
|o-|-|-TM--E---||T---o-----BB-|--M-X-To----M-o--M?----MoT--E--|?-oE--EE--T|-EX------?----Moo?T-TE||?----|--?-T--E---EE-X--|XT-?M----|o|--||-|----M------XXET-oT-o-XB--?EXMM--o-----B--XM-Xo--B---E--BBoM
|o--E--M----|----BXT--T----X---|------E---?MBX---XM|ET-?B-?-X?oX?oB-EE----BXEE-B--|MB--?|--E-M----oT---o--o-?-E--M--o---|??--|----------|--T-o----TB--o-Too|----BT?-M----E|X|--ETB?B-o--B---|---o-BX-M-X
X-----EM-----?-----?X--BM-BM----B--E|--E-X-?---o-BoE--E-Eo-?BE------BX---B---E?T|-----M-Mo|E?---?T-EE?--X||o|oo?-E-T-o--X-?-B-X--|-B-B---M--E-EMMB-------BE?---B---XEXT-T-|---|---M----|--M?--?T|TXB---M
E-T-B--EM-|--------o-BXM-E----M----B-|-T---Mo-TTT-X-BX|---XEXoM-|??-B-----X-TX----oo-?E---B?-B|-?----T------XET--|--ooMB--M--X-o--T-B-BE-EB--XBT?-X---E--EX-X-MTE?---B-EX----E--M---B-|-M----X-BXX--o--|
---?---XT-----|?-o------M-E--XE---XE|oX-T--o|-|-----B-XB|E-T--?--MBT--|o-----o-MT-TB----X------|o------o--o--B----?oo-M--o-ToE--To---?-To-TTE-----TM----TB---M-T--TTE-X-|T--o?-MXTE|--|B-To|E-ME-|EXE--o
m?X----B-E-T--M?-E?-E?-Bo--|?--T--?-E---XXBE-o-E-To--XMT|M??---oT-XM--T|----?-T--MBT-|-TMMXM--||TTB------oB-??--oM|------X--E-----o|B-Xo-|B--|-||---|o|XMo--BM-B--E-o-B---M-o?-ET----o-o--T--E-o-T----To
XXXXXXXXXXXXXXXXXXXXXXXXXXXXXXXXXXXXXXXXXXXXXXXXXXXXXXXXXXXXXXXXXXXXXXXXXXXXXXXXXXXXXXXXXXXXXXXXXXXXXXXXXXXXXXXXXXXXXXXXXXXXXXXXXXXXXXXXXXXXXXXXXXXXXXXXXXXXXXXXXXXXXXXXXXXXXXXXXXXXXXXXXXXXXXXXXXXXXXXX
