-EX-E-o?--------|---E----?M--?--Bo-|TXM?--oXB---M----------E--M----T---??XM--?---X-B-TX----B-TE---E------EM--?---o--MM--M----------|T---o--E-ME-TX-o-?---B--EEE-----ET--|--T?|o-----oX-X------TX?B------
-?--BM---MM-M-----B-B---?-??X?-M----MM-B--X---E-X|B----BT----|T-E-T-|T---oXE?T||M??MM---o?|oXE---o-M?BX--B-o-|--------|---?-B-oXE|?T-?B---?Xo---|-?-E--oo-o---B|XM--BB--??o|XBTB---T-X?|T-XE------TM----
------?oM--TXoX-X-oX-M--E-|oX?XTM-T---E||MBo---|---TTET|--MEM----?--?o-------XTX--------oT--B--EEo---M--TT-----oXEX?-|TB|o---B--?-M--o--Eo---o-M-T-ToBE-M-X-o|T--|-?-?T|o---|T-T|--?M-X-X-?---XB-TX-E-|-
--?MBB----M?--o-ooEMMo---|--M-T-B-|-o--B--X--|----BT--oET----X----?M---E-oXM-X-E-----To--------XM-?E-o-XBE-B?|T?--B--o-T-X---Bo?-o--|M--BoM-X-M--|-E-XX-|EX----M---ET---o-Bo--|X----X-XXM-----E--|-X-o--
-o-M-o--?---|o---E--M-|?--o?oX--T-M-o--?-TB-B-----?--B-oE-o-EEE--BBo-B-EX--E--T--?--|EX||o|T---?--|B?--M-MTEEEo|-X----T-----T|---?--o-o|oo-oM---|--ET---E--B--M-E-o-?--E|o------?-?XXE?-B?-|||o-o---XM?-
--E--o-o?-----TBX-----Xo-o--M----TXETT----BBE----T-B------M-MB-X-|B?--|E-M?---X?X--T-?------XE-M---?XB-BX--M------|oT?XT-E--|E-----oTXTM--BX---X--?Xoo--M??-T|-|?--Eo-M-|-?B-X-E-|---B--o------E-?--E-X-
-X|----o|-o-EoB-BT-T|----E--ToTM?--XTE---E|-M--E-TX---?E-M--oX-EM-o--M---o-M-XB-M--E---B|E----o-B-?--TM--EB|--?|-X|----B--M?--X--?X--TBB|-||E--o-|-?|-BX|X--EMB-?----EM|B----M-EX-E--B--EEX---?ET---ME--
-|X-o||--B--T---X-MB?---E--oE-?-E?E?-MT-?-B--o|-|?oX-----o---oET----------o-oM-B----oX-||--|-?-B-o||--M-------MT----X-?-TBoB--TM---EM---B-|-|T--|-B--EX|--|T-----BX---B--|-B-BBo|-|-T|--|-X-|--T-?--T?-v
--E----Mo--o?T-X---EMXE?-----|---|-MT--TMT-oE-B------TMX-|X|-----B-T---M-TX-MTo?-o?------T----o-E-E--T-|------T?-?-E|BEM-B-M|B-B-|XE|-T|E-o-X-E-EMM---?o-|M-XM----X---------?E-B-?-o?--oMX---X-BB-o--TEf
---|BM--T-BT-M-o-----MX-XE-XX-|TT---o-BB-Eo-?E--X?TX--?T-B-o|o-|M?-?o--|--?Bo-o--oo--BM------BT-EB---MoEoX-MB---T?oX--E--X-XM----X-?|---|-E-TX-E--E----EB-T---?---?X|---M-?---E-E--B----EM-X?-?---oTB--f
-|-oT--o--To-|------T--?E----------Bo---X-B||EX--ooT-oXE-?BB-E--o--X|-MEM-B--?--B-|--B-----E|oB--X?-X-X----?-M-||E-------X-?--------?---?To?B-X---?|T-?B---M----M-------?B----oX--Bo--E---|---?T----?X-f
-E-M----B-M-X---XTEE--X--BX-ooMX?-----XM-B------TX-E?o-EE?-ooT-----EB-----o-?----?--?--MX---?XM-?-?-B-----M----|TE-X-BT|?----E-----BX---oEToo--EM?o-E-?---B?-E-MMoo|X--XM--X-XBT|--?B-oE---E-oXoXE|----f
-|BE-----E?o--oX?o-|---X-|-T------E----o-B---oBEBB--------Mo---E-|-E---T--o---TEEX--?------o--E-MMo----|?M--o-oM---|MT-BTXMMM--o--|--|--T---B?|MX--------o---|-|---o----|MT-BT-o--|-E-B--M-----To--EoX-f
--Mo-------B--TM-M-EB---B-|-M----?---TooE--B-?o---?X--------E-T?M|XB-EM-o--?B-?B---ET--o-TEE-BE-M?BM--oM----TM-BB-oEo|B--|---XXE--?EXBM-M-M-|ooM--E-E---B-?B-E--M--EToT----MX-?-?B-M?-B--o--XB-----M---f
m-To-E-o--E---o--M---o----X--XBXo---|o-?-XB-?-E----X-XX?-M-TBo|---ET-Xo---XEB-?M---B-|-----T-B-BTT--ME----B|B--MEXoBE?X------oB---o-TM-??---|----EM-o--T-M---X--|X-M-X-o----M|--oE--T--?-?T-E--M?-X--oMX
XXXXXXXXXXXXXXXXXXXXXXXXXXXXXXXXXXXXXXXXXXXXXXXXXXXXXXXXXXXXXXXXXXXXXXXXXXXXXXXXXXXXXXXXXXXXXXXXXXXXXXXXXXXXXXXXXXXXXXXXXXXXXXXXXXXXXXXXXXXXXXXXXXXXXXXXXXXXXXXXXXXXXXXXXXXXXXXXXXXXXXXXXXXXXXXXXXXXXXXX
