o-XM-|--oET---XEooT-o-?T|-oTT--?-X-B----------ETo-XB-oo-B--E-|EX-|---o---M|T|X-XTT----M---------MM?-----M-BE--?TX-?-?-BE---M|-X-XT-T?--Eo--M-o?--|XMX-T-M-BB--?E-BB-TB-MMX-BM-T------B-E-?B-oET----|E--o
|---BX---|--BE?-?--E-----BE-E----T---M---------oT--?---T-B----M----T---E-|---BB-E--E-To-X-ET---B-B-------oM---M-B--M---E--?---M-?BBBX?-E-B-----B-M----ME---X??----BTX---T-----|-|M---------E-?-?-T-B--??
E-o-|X-o-BBEM----M|--B--B---?M-BMX--BET--|---T?---E-T---E-----E---M?M?-B|---------|-|----?X?-?--|T-----T--Mo?M-XX--o---X|---EE--T?---To-BE-T-|-Bo-E----?-----|-BET-----MT----B----?-o--------X-B---?oTTB
-B|B-T-BT?--X-M?-X-o----B-?E-|-EB-B--B------|o-----MMT-TB---EEoE--B-M-?MT-?B----M--|--T--|-T------EX------B---?M-|?--E-B-B|-?--B-|M----?--BMB---BE-XE--B--E-T?M--E-----E-E------M----M--B|M--?--|BE-?M-M
|---M--TTTo?----------------EBo--?-XEB-EE------E--T?T-o-|?--?M---?----B------M--BB---M----E--o--BB?-----M-To-BoB|-|M?|-------METMT-?---B|--o-X---BB-oEE--TB-B-?--B-|---o----XT--|--M-?-------|--|B-|M--|
?--------E-oME-oT-ToB--?-|-|----?B?|-M-------MT---T-|-B-?|B-E-|?---|B--|X----|B----?|B-|-ET------?--X|BB-B-XBE-T|?-o-?BM-M-E--B-----TBo-B-X-?-M--B------|B-----|---E--BBMTo-|?E-MM---|BE-MEo-------E--|?
X-E---|T--X-T-|--?|----|----T------E--X---E|---E--oo--B?--|-MB-M--TX----?---T|-------M----M|--|-o---------EBT-T||M?--------Xo-B---BE----|B-BE-B--?----EM|---X|-EXM------?X--|---M-|Mo-B??--?EBM?MT-M--BT
MTB-E----XT-M----o----M?--M?Mo-|-X-T-B-----BT-X-----BX--|-E--E---B---|-T|--BME-|----|MBTX------BT---E--?-E-------B----B----B-o|-o-T-B----Bo-B---?Xo--BX-E?|MM-T-----B-ET-----|T-T--E----BT------?o--|E-v
-------X--M---E|M-E-MB--?T-oB--B-T-o|B-M-?BE-M----EME----EEB--E-E-XT-------------?B--?-----X-T--?oT-B----T---T---B-?---B?|TM-B--?-TB-?-o|-|-------B---B-B|B-BM--?|-X-T|o-|?--M-TXTT---BMX---E|-?EB--ooBM
-----X---M--T-MBo--E|--MT-BE--|-B-M||T-BXB-E-X?---T-T-----??--M-T?B||---EB-B----?oB---E----T---B------X---MMBB--E----BB--|-M?o-E-EB--M---T?-T--M--------M-M--B--|-X-E----E-|BM--M-oB-E-T-M--?--T--E-|-Bo
B---E-?-o---EMTEo-B--T----B----|?--M|o?-MB-M--TB-?-BBMT-----T-T----BE---|TMT----o--E--EX--X-M-MB-E--?---M|-M--EB-|-B?T----T--oM--??--|--|-----?-----------B--?--T|--B-E?---|------B|-|-|------B-?--?---X
?-?EBXE|----E-|?T-|---?-B-BB--X-Eo?M----XB|---B|||-----MX--T-oT--T--ooX--B-|------B-----M----?|-BB-M--oToM-----|--B----B-----B--T-MM---M--T-----B-BXoBMXo--|--|?-EE---?E-T---EMEM--B???-X---|oBB--B-X-Eo
EE----M-B|--B--X?M-X-X-??-----E---|E-??-BB-??-MB-MB?---------o-T------|----T---E--B|-MX?--E-BoB--?B-----M--BBMT-|E------T-|E-oM---B-TEME|EE--M----X-----------BEB-B-E----|-B---|E|M-B-T--B-----T--|BBBB?
|-|-M-o----???-------BB|----M---TE-----T|T?-?-BE----T---?-Xo---?E----??XX|M-E-B---|M?--?---M-E---B--|E----X-EE--|-Bo-T|--BXEMTB--o--?---X-MM---o---|-o-?T--M-M---M-T-----|----BT-ET----M-T---E|----ET|-|
m-?--XXB-----?-T-M---MBM-|T--E-M--TTB?---oEX----?--||M--E|-E||M--BT-E?-E-BB-----XoM-T-M-EB-?|-XB?-EBo---ME----M--T---B--?BE-M|-E-E----B---?o-E--T|-X-MB---X------X?--B---BT-?T-?-TTM--BEE---BBB--?B-----
XXXX-XX-XX-XX-XXX----X--X-XXX--XXXX--X-X-X----X-----X----X-X--X-XX---XXXX-X--X-X----XX-X---X-X-XXX-------X-X--XX-XX--X-XX--X-XXXX---XXX-X---XX-XX----XX--X-XXXXX-XX-----XXXXXX-X---X-XX-X-XX-X--X--XX-XX
