XE----?----?-?----B--?B---?-o?------E----T-Xo-XT-|BX-?E?M--E---Bo-M--|----M--E|----X?X|---EMT-B|o--oE?-ME-----T---XX---|?---BE|--?|-ET?Xo-M-M-|--XT-B--X-?--TBTTM--XoT--o|X-T-E--|---M-M-B-B--||----B--T
-T--MTB-o-MB-|--EM-B-B-B|----T---ETB--E-?--?-X--BEM-?-TBE--?-TT-X---B-------B-EB?-B?E--------oB----T?-------|--ETo--??X|XT----|--BT---|-M--|T-----?B---|E-TE-|----TM|-B-?B--XB---|B-B-M-B-T-BB----X-Mo-?
?--T---M-------EX--?-?E---E-|---|M---MMB?E--E-E--T--B-XEB------------EXM?-B--?XB--------B-M-XTo-BX----XM|E---E-BX---|---B-MM?-?-----MB---------|--|-X----B?o-?E?M---TXM-E|T-EX-oB--XMX-M-|--M-MBE-X|----
|X---E--X|----|-oX-?X-BT-M?XBET-o-?oXT---?--|---EBBT----M?--------?---B|-------X--T--B-M--TT---|BE--B?--Bo-oMX---X-B-|T-XBT--MM-|E-X--X----M----o--T?--B|oE----B---|-XTME|-B-?-X-|--T---M-T----B----Eo-E
MM-?-----T-|--B-?Bo--E-T-B--BE|TM?T-?-|B-T---|-TB---T|---T-X-E--T--XT----M?---E-Eo-|-?oE----T--B-XE-BX-----ET--X-M|-----M?X---M------BB-B---|E|--M-?|-?-o|--MB--?M-EB------E--T-X-E-M-T-T---B-----E---XM
?E--BB||-X--|?--|-?T--T---T------E---M-o|T-Mo-TBT----M-T-B|MM-T-BM---|B---?X--TBM----X--B-?B-Bo-|T----T-XB-E--TMEE-o--M--M-M---X-?E-|BMM------X-M--?-XMBB-T---X-M-----E-?BX--M--EMTBo--E---?B---T--E---?
|E-M----|-TM--B--E-BM--T------E--TM---X-X-M-?-B----X-MX-X---E?B--E----T----M--|T-?o-----T--E--B-MB-MB------XoX------E----T--T----T?-------T-B--o--M-|B---?o-M-E---B-------|X----B-T---B-T-|?-M-?--E-T--T
o--B---BT-|--XMBB?BET--|E--B-?--XBTB-BTM?--|-|-E--M|o---|?|TXT------|T--B-----B--||--E?E-|--B--?------B-TE-B-M-o----?MTXBBM------B-----X---|--------X-----T------X---T--E--|--B-BMMX--T|--B?M----BB||--v
o--EEB--?M----T?-X----E---T--X-E--|X---|--M?---E--oX-E-----?M-MB--X|--?B-----Bo--M--B-?---B|--ETX|ET-|oBXEB|B--BTE--T-XB--?---o--B---T-XE-----o-T---X-------M-?BB-E--BB----?--X----o----B||---BB--T---oo
M-?B--?--|-B--M----MT-|o|--?--B-BTB-|ET----X|T-B-X|-T-BXB??-----TB---?-X--E---E--BM--|XEM--M|oX-E---oE--X-?BBE--X-T-??X-B-B--X--|oE-BB--|--M-E-|---M--B|o?M-TB||B-|ToEX-----E---B-o-M---|-X-o----M--?-M|
EEB--|--E--X--?BM--ET-B-X---?---T-XB--XE--B----M----BoT---TB-X-M---|EB-M|?----BE|E---X?X---M-|--TX----|--Eo--B|BE---E|oB--|-?-M-T--XT---B-T-o-?---|X-----T-E-|T----B-M-BB----X--TXTE-BB--ToT||----?---E?
|?---oo-----------T--B-X?E|-oB--TX---?-E-BMEXE-B-o-o--|M--X---M---BB-T|B-X--X--B|--MME-T--XBXM?--B?-|---X-XTX-X-B|----|-MB--B-?----|-M--B-|--??E-M--------X--?E-|-------|E-?----B|----X--E-?T------T-|-M
X--MT-TB---TX--?--T-|------X------oM---E-XB--B?----X--X----B---T-E-E-M--------XB-B-X-ETM?-oME--XB?-T---E-T-|T-?--BTT---Bo-----TBX-|---MM-M--B-----------XBTT|XB-B|-To------?E-X-o-T-MB--M?-X|----M?T|?-T
|X-B----TTE--EX|M-X--X-BX-|-----o-T---M---BB-|o----X-|---??---B---BB-B-?-ME-?-?TXE-E-?--B|EBo--B?TM-oE--MBT|-?---|--TX--o-----|----|XTM--T-XoM--X--M|--?-B--E----T-------M?-----B?-T-E---|-BM-M-X-E--?-B
mB-?B-E-TBB---X---|--T-B-BE---oE-?EX-M-|-EB--TM--X-----XEXME-----?-M-?T?-|-E|--MX----X---B|-o|TM----|---X?-----MT-M-----?-?---XE-T-E?-E----?-------TM--E-----X----E-|--M-||---Bo-T--BE-----E------?-oTX|
Xoooo--ooo--o-o---o-oo---o-o--ooo------oooo--o----oo-oo-oooooo-o---o--ooo-ooo-o-oo--o-oooo-o--o-oo-oo--oo--o---o----o-o-o---oo-o-o-oo---oooo-oo-ooo-o-ooo-oo-o--oo-oo--o-o---o--o----o-o-oo-ooo----oo--X
