oB--E-X-X?--B--MM?-----T-EEE-o-BX-M-?---?BBTo-E---B|X--X-E-M---|MT?-|-M-T-----MoX-E-|M-?--------X-----------TM-|E--B--o-E-T-?-------o-TT------o---XMT---EMB--B|Eo--X|----BE-M---B------M--oBoM----T-o--?
---MB-o-BT?-X?--o|T----TTEo--BX-X-M-|?-M-E---??---|-XE-BM--T?-M---X|EXoM|X--M--T-|-o----M|----TT-E-|---?--X?oM-|--|--XE--M-----B|-|---E-X---T---X-|X-?|XBM||---??-E?---------?EE---o-o------T--|--TBM??o
-M---------X---o-X-|--o-o--M?--X-o?--oE--E-B---M-X-----XM----XX--MTXE-?-X----E--oX-?o---ToT-X----MXoE---T-T-?M---?MXX?E-||-?M--------X-M----M||E--E?o---?--ME--X----------E|-T----|TT--EoX---X?T--E?--oM
o-B-----X-BEB|---X-----To|--TE--o?--?-ME-XM|----?-B--E----??---M-----|-oX----o?----M--?-BE?----|T-----B??M--EEBX--M-MTB-EX-?BoB--?XB-M?oo-MB-XM-|?-ETo?--|---E|o-|-XM--o-T-TBM--------M|-?BTo--T|-o?B--X
?o---o--B-M-?--T--o--|---X--T--------E--M?------ME-?----o--M-B---?-M--o-oToT--|--M---T-|--EoX--T--o----B--X|---M--XE--|?-B?-|-B-MToX?X-X--|--M|----X||-E---BXEEM-TT---T-ME-M--?-?E---T-T-----|----|-B--B
B----|-M---To-X--X-o---TM--BM?X------Mo--o|?----B-B---E-M--X|--B---oo-o?---MT-o-X--E---B------oM-B-BET-BT-E------|-o-----E|MB-B-|M?--?--M--B--B---MM-Eo-TX-XB-|-----M------?-E-o--?T--o-TB-|--M-Bo-----B
EB--|oT----------BEEXEB?-B|X---EXoBT?oE?---o-|X-E?-|-X------TTTM-E--E|-o--------B-E---T?T-E--M----T--------ooX----XE-----------BT-?oo-Xo----Eo----XT----T?|--o----|o--Eoo---|---|B----TE---XT--T--BE-|-E
----|---??-B-X?-----T-X-B----X-X-T--T--------B-|-B--X--?E----oM-o?|----TTT--|--?T-|-|--Bo-o--M?T-TM|--EXBT-------M-?X--?-B-o---?oE--XMEoB-------?Bo-BXT----T-----B---?MTEM--X-E----M-X--T-X-BMME--X---|v
X---T----X--M-----Bo-?-E--o--|------BoX-XMo|-EM----T-E-T-X-TMoX-o-|oE-??--EE--TX-----oXX-B--|||TX|-B-M--BMXoB------?--o---M--E-BTXM-?-EEMX--|M?-|?X-|-B---oE|-o-----------T-|-EBMX-E---|MEE---MB-EoE---|
M--??-|M--M-|-BM--TT?X---M--E??M-----|-BEE--?--TX?-----X|?MX--XE-----o-------T-X-X--------MT-X-Bo-|X------B--?-|-EX---??-Bo---EX---|-E------|-BBE------oEoX--M|B--TM----|--o-T-?Xoo-X---?---M-TE--|----B
XB--|-----E-|-X-E-M-E--XM---o--X-B--BTE?---M?-o--X-|-B-o-?--X-o-B-EB-----EB---B--M--o-?T---?o-|-T---|??-TM-----|----E?BM?o--T-|----B??oB-----|----X--M-MM??---B|X?-BTT-TE|--|----o-o-M-X--??MBo---?-M?-E
M------?E---o--?--X--BE-XEB---M-----o-------?-o-?M-XM-|?--o?TE?--T--o---o--E-M?-----M-oE-----XM-T|oT---?-?TX---?-?--T?E-B?-T|X??B-T|--?TMT-X-XBMMo-TM--XE-TT-B-|Eo-X|||?--o--?BXXTE--E-o--B--|-----M|-?o
T-|-----T---E|-E--M-E-ME|-T-T-BT--X|-X--E-o-oBE---E--o?----XT?E--TX-oEX-?--M-T-B--X---|---oEX-----B--o?---B-B--|T-------|E-oB------BM----?--B?|---BMo----|MoE-XX?|TB--X|BM--E|B-?o--MEX-o?X-E--E--B--|--
M----ME-X-T--T-?-----o-TM-|----BB--------o-o-o---M-T--E|--T---BT---?-----|-X-X--BT-MX-E--B-------ETo-X------Eo-?----ETXoT--??-MT--Xo-T-|-|-BB----MT--?--E-T---X|-M--X--X--B-|-T-TE--|----------M--?M?-M|
mE-XM-E--o-?oEMB---To-BE|-ET-EEET-MEX--o|oTE--------oE-T-MXT---MTE-o--E-?--?-EB|-o-E---?----T---------M--T-M---|-T-B|?|--B-------?---B---T-XM?-BB-TB--M--o----E--M?-X--Mo--oB--B---M-E---XBoEo----?T---T
XXXXXXXXXXXXXXXXXXXXXXXXXXXXXXXXXXXXXXXXXXXXXXXXXXXXXXXXXXXXXXXXXXXXXXXXXXXXXXXXXXXXXXXXXXXXXXXXXXXXXXXXXXXXXXXXXXXXXXXXXXXXXXXXXXXXXXXXXXXXXXXXXXXXXXXXXXXXXXXXXXXXXXXXXXXXXXXXXXXXXXXXXXXXXXXXXXXXXXXX
