B-?-??-----EM---X|Mo----?-E-M------?----?--|EX--?T-X----E-----?--E-X-----X-??T-ET-?B-|-M--M--?EX--X--B----E-----MM-E|T-------?--|--E--M----B--M-----|?----Xo--B-M|--o----T?-XBT-E--MB---|--MM--|B-E|oB-?
|-----oT---oEXE-T----T||----M--|?||-----TBB--E---E--o--E--?B-T------|-EE?-T---?B--|---?oB-B?|M-?B-B-E-B---o--B-B-----|B--EE-BBTTX----o---|---MB---|o-T-X??--BM|-E---?|-E--B|-----B-B|--|-----EEo---M|-XE
B---?-|---M-----?-??B-oM---XoM-|M--M|TB---BEBTT-----B--T-------?M-|B-E--T---||----?---XB-----o-----M|?--X-|-TT-----M-BB---|E---BM---?-XT-----?E--?BB?Mo-T-?-BE?BB-M-??----BM-----||--B-T---M------|-BE-B
XBB--X-?-MM----|-M|-X-B--B-B|BE|---TB---TMT-MB-o--MT----?M--E?--|--B-o-B-----XB?---|---B-----M-M-|---------X?-----B-E-?B-----||?E----T-M-ET--?TX-?o-M-B-?--o-?-----X-B-|--------T--M-o------TM?BTBToT--E
?TE-B|----T---E---??--E-ME?--?-?TM-??------E--?---EB-M----BMo-B?o-XE-o-XB------o--M-----B-B||E---BB|BBM---E--B-TBT?MBB--------|MoM-M-MoE-?|-B-?T--E--X?----MM-B--?BB--?-?--?--?-B-B-----|-B------B--?M-?
o--B-M|---EM-E-oB-BT|T---E--M|M-T--TT-X--E-BT--BBTB?oBTB-?---?--Mo-E---X-?M-B?MB----M----|T--T--------BE-----M-B-X--||------M-M--?---ME--------M---B-E-B---MT?-MB---BTBB-E-B--E-E|XM-BX--BT---?----B|--B
o-------BB-TTB|--?-o-B-TB---?--T|EBM---?-B------------|-?-E--B-TX--T|--?--E-------X-----B-X---T--X-----|---E-o--B--?---TE-?--E-|E-T---TET-E-T---o---o-MM|-||-To|EE-E---X-|---|-|E-MM-MX------oM--EM---EM
E-----T-----B---ET-B--?o---EX---|----|--|-T-M--B|--BMB--B-MB-o--?---B-T-------?-M--|E-|-?-B-T|E-T---To-B--B-M?B?--XT|-?Bo??-|---EETMM--XB-----o?MB-B|----|?|M--X--X-ME----o-ME---?---X------|T----E|B-Bv
TT-------X-------E-X|BM----B---M?---T-----?B-B-M||-------B--T-M---?-?--o--XX?XMTE---M?-----E??--B---oB-?-|||--B-|-T-T--ETE|----T-?-----M-----T?o--E---------B---M|-B---M----BXM-o--o----?T--T--E--T-E---
o----o--M-EBE-M--o---BB--T|E-T----B---B-BMB---T?-T----B----B?----------M--E-------B------B|---B|T---E--TB-E-E--?T--|-X---|-|--?|-TT--|E--X-B---------E---|--?------T--M--|--E?---?-MTEB-?E?----B--|---??
XEE-|-|----|-T----T-??E---B---ME-|---M-o|B|-T-o-|M--TMo-B?-?MBX-|-MBM----XB|--?|B||----|BE-?--M|o------?o|-B---B-?-T-B-?--|-|---------T-M--T---EE|--TEM-BB-|-B?--?TB---B-TT-M|-|--?-o-EBET---oMBBoT--B--
M-oTT---B-B-B-|M---?-E---E|---Xo-|--X-|--oX-E-?---?o----E----|E---B|-----X---B-T--M|---?--------|M-B--BBM|-B-?-oMEE---?-BX??EEEB--oT--E---BE-|-M--BE--?---BBE---M-M-B-?Xo-oX--E--BBE--TB?-B-|----XT-T--|
E------||?--M--E?-MT|---?--?--EX-B----BX-----?-|-B|-?-M--M-|---X-MEMB-|-------B-|oX--?-XEB---B-E-T----?-ETB-B-----MBM-TB|E----|------------M----?-M-B-?----B---M----o--T?T-?|----BB--E--M--|-E---M-----|
BB----o---T-----o-B-B?--T-----T-----EM--B?-|----o-|T---------|-o-|---------BX----BB-?---M--E-----MT-----B|oXBET-o-o---Bo?---?--o--M-|o-XT-?EB---M-?--MEB--E-M--EEBoB-|-----B-X--oTM-B-E----E----ME-?--?|
m----B-X--MXM-B?--T---|-TT---T-|-B-TM-X---BB-BM--TEM------B----------M-M-B----BM-E|---ME-E|---M|----TT-X|B-B?-E-X-M-M---E-?-BE--BX-?-EM-M-M--X-T-X---M?|M-E|-BE--TT-EET-----?-----T-TM|E-?---??||--T--B-
XX--XXXX-X--XXXXXXXX-X--XXXX-X---X--X--------XX------X-X-X--X-XX-XX-XX-XXX--X-X----X-XXXXXX---X--X-X--X--X-X-X-X----X-XXX-XXX-XX----X-X--X--X----XX-X-XX-XX----XX--X-----XXXX-XXXX-XXX----XX-XXX-X-X---X
