MMM--T?M-??X-M--MM-T-?M---B-BMT-B--T----B----T------T-T---X--------B----?---XT---?--X?---|-?-BT?X---X---B?X?----|?T??MM---T-BM---M--?BB?--B|X--??|B------M-M---M-------X--X-T---|-X-B-T--XM-----?--M-TE|
?-B---X----XX-M--B-X---BX-|T---BM--M-?----------XX?|T---??|-MX?B-BT--T-M?--XB-BBB----------T----?-X------XMXB|---X---?--M--T--?-X--T?X|-|B---------------T-BBX-T----B?-X--TX|-T-T?-M--X--?B-|M-----M---o
BMT|-XXXM-XX---B--TB|-B-M?BB---T-M---T-B-?-B----MM--------T-----?-T--|BX-MT-?T-X-----BMM?B-------MX|T?------X-M?-M?--BXX-|B--BX--TX-?M--?B---T-B-?MT-----BM?--?-|------B---X-------------M-?B--B--M?XBBT
M----BT--B|-?X-X----X?--M--||-?--M?-X-------T-MMM---T----?|B-?-B------B-?M-?-TB---T-T----TB---BX--BBT----------TM|-?---T-M-|--T------T?B-----|-TB------|T--|-X-BMT----B--M--X--B-|-?T---?--?-X------M-oE
?-X----------?---M--TT--|B|-?--X?-BM-MTT-----BT-T-XB--?--M----T-X---T--------|---T-------------B?T---?-----B-M-|---T-T---BX?-M-XX-|?-M--|---|---XT-B|--|----??-M-M--X-BB?B-X-B---B-----B------B--B---MM-
---T-X--B----?---M---|--T-T---|---------??|--B--|?----B|-B---BX--T|B--B-|BM--B|X----MB|?--TX-?---?B----XBX--X--X-TM-----B---X-|-M-TX---X-|---T-M-?------TM?T--X?----|-B-BXB---MX--XX??|X--T--T-B?-X--EBE
BT------M|M-T-BMM-|----BM?---?-------|-----T--XM-TM----B?-?-X--X-?BT---|XX-X--?BT-B-?T?|-X-BM---??-T-X--|----B-?-----BM---TM---M|-B-|----M--T---X-B-?--T----T-?X---?--????|||-------B-B-----|?|---X--T|E
T-|?XTB|------?-----?----|-T---BBM----X-M--?-?-T-B-------?-----MT---?X-BTB?B-B--M--M----XB?-T-----|-X?M--T---B----X-B|-X-M?-B|?----?------------M--BMMT-T----M---?----------TT-M---?-----XBMT-B-T-T--v-?
TB-M-X----|M-M-MB--MM---B|T?-------B-TB--T--?-----?-?--T|-|----B--|--B?T?-?-------X---X-----?-?-|--B|-B------B--?--TT---T----BB-X-----M-B--M--|MBB--?|-MTMB----|--|-B-X-|M-T-|--B--?-B---MB|-BT--X--|fTE
?---?----X--?----T---MXB??-M-|--B---X--|--?---T?|----|M-XTX-----------X|--?--?-TT----M--M--MTXM-?T----?---|B?--?-B--|M--|?-MMTT-?----T----?---|----X-M-|--|-?-B--T---?B---X||--BT-M-X---|B-M--M--|T--fXo
B-TM??-X-?B--T----|-----?---MX-X-T--?T?T--M--??X---X-T-|----|--TT-M-----X---MT--M-X---M----?-T-??----M--T?-M--??X-XBB---XTT-----X-----?-MX-M-M--B---T---X--BM-T----BX-----B-?----------X---B?X-----B|fT?
M---M-----X---B?-||---B---BT|X------T--BXXMX|-TB----|--BX--B--MTB----XT-BB|T---B---TB----M-M-BXT----T-T--T?--M----|MMX--|--T-B-|TMMMX-----TX--|-----TM---T?--T--X-|-T-||---X||-M--|-BB----|?-?-|-T---fo-
B---M--?T-----XB-M-T----?T-MM-M-X---?B-------|------B---------XTB--?M--------M-----MB-M-B--XB|B--|---T-T?---T?M--?X-M-|-BX-XB?|-X-B--B--B-XBX----?XMT----M-T-?T--T---|BM-B-X-----B-B------MX?---MM?--fXT
-----------------------------------------------------------------------------------------------------------------------------------------------------------------------------------------------------f--
m----------------------------------------------------------------------------------------------------------------------------------------------------------------------------------------------------X--
XXXXXXXXXXXXXXXXXXXXXXXXXXXXXXXXXXXXXXXXXXXXXXXXXXXXXXXXXXXXXXXXXXXXXXXXXXXXXXXXXXXXXXXXXXXXXXXXXXXXXXXXXXXXXXXXXXXXXXXXXXXXXXXXXXXXXXXXXXXXXXXXXXXXXXXXXXXXXXXXXXXXXXXXXXXXXXXXXXXXXXXXXXXXXXXXXXXXXXXX
